民猪	反动
抿主	反动
清真	反动
基地组织	反动
杀毙	反动
江祸心	反动
默罕默德	反动
弹药配方	反动
沈阳军区	反动
丁子霖	反动
亡党亡国	反动
北京军区	反动
请命	反动
抵制中共	反动
罢工	反动
谁是新中国	反动
炸yao	反动
圣战组织	反动
关闭所有论坛	反动
韩国狗	反动
抵制李鹏	反动
民主女神	反动
twdl	反动
城管暴力执法	反动
shangfang	反动
蒙古分裂分子	反动
网特	反动
宪政	反动
戒yan	反动
军转	反动
wikipedia	反动
台海战争	反动
人木又	反动
89年春夏之交	反动
dalai	反动
习近平连任	反动
zangdu	反动
引起暴动	反动
台海统一	反动
zang人	反动
拉sa	反动
抵制温家宝	反动
抵制江泽民	反动
集合	反动
政治风波	反动
十九大修宪	反动
江氏政治局	反动
a扁	反动
zhayao	反动
入耳关	反动
国际特赦	反动
赖达	反动
塔利班	反动
中共独裁	反动
中共帮凶	反动
激流中国	反动
发生暴动	反动
4事件	反动
形式主义	反动
知道64	反动
静zuo	反动
吾尔开西	反动
民运人士	反动
7大军区	反动
网评员	反动
学潮	反动
jieyan	反动
mayingjiu	反动
启蒙派	反动
讨伐中宣部	反动
hmtd	反动
金盾工程	反动
回教	反动
维权	反动
西脏	反动
民一主	反动
学chao	反动
麻醉药	反动
罢ke	反动
qingzhen	反动
互联网审查	反动
大赦国际	反动
gfw	反动
阿拉伯	反动
爱国者同盟	反动
封从德	反动
江蛤蟆	反动
台毒	反动
胡平	反动
网络封锁	反动
台湾共和国	反动
六百度四	反动
台弯	反动
一党专制	反动
解放军	反动
穆罕穆德	反动
进攻台湾	反动
打倒江主席	反动
藏独立	反动
西臧	反动
六和谐四	反动
中共洗脑	反动
回族	反动
麻醉藥	反动
王千源	反动
维吾	反动
三个代表	反动
恐怖份子	反动
江主席	反动
陈随便	反动
高自联	反动
访民	反动
当局严密封锁	反动
请愿	反动
蒋彦永	反动
汪兆钧	反动
zf大楼	反动
两岸战争	反动
列确	反动
中国人权	反动
chinesedemocracy	反动
ba课	反动
炸药配方	反动
台du	反动
境外媒体	反动
九学	反动
江绵恒	反动
疆独	反动
罢运	反动
星岛日报	反动
一党执政	反动
googleblogger	反动
自由时报	反动
核蛋	反动
dizhi	反动
游行	反动
四事件	反动
一党专政	反动
啦撒	反动
静坐	反动
安拉	反动
4风	反动
伊力哈木	反动
jie严	反动
抵制共产主义	反动
麻将透	反动
中共保命	反动
汉维	反动
bbc中文网	反动
台海局势	反动
西奘	反动
社会主义灭亡	反动
上中央	反动
鞑子	反动
三股势力	反动
xuechao	反动
威胁论	反动
吾尔	反动
柴玲	反动
谭作人	反动
霸工	反动
拉萨	反动
任期限制	反动
四二六社论	反动
中共封锁	反动
南街村	反动
dl喇嘛	反动
火乍	反动
左翼联盟	反动
64运动	反动
北京风波	反动
8的平方事件	反动
十七大	反动
兰州军区	反动
小泽一郎	反动
江派和胡派	反动
网络评论员	反动
蒋公纪念歌	反动
出现暴动	反动
选国家主席	反动
万人骚动	反动
陈一咨	反动
群体事件	反动
党章	反动
截访	反动
强制拆除	反动
光复民国	反动
喝血社会	反动
罢吃	反动
中华局域网	反动
达赖	反动
北高联	反动
血书	反动
特共	反动
江戏子	反动
八九年	反动
规模冲突	反动
臧人	反动
劣等民族	反动
中共任用	反动
河蟹社会	反动
x藏	反动
辛灏年	反动
上访	反动
江太上	反动
反共	反动
步qiang	反动
天灭中共	反动
bjork	反动
人quan	反动
万人大签名	反动
希藏	反动
198964	反动
投公	反动
罢学	反动
中共的罪恶	反动
baozha	反动
西z	反动
xi藏	反动
昝爱宗	反动
攻占台湾	反动
you行	反动
游xing	反动
x民党	反动
中共黑	反动
罢食	反动
抵制江主席	反动
江氏政治委员	反动
da选	反动
灭亡中国	反动
霸课	反动
罢考	反动
la萨	反动
北京帮	反动
台wan	反动
印尼事件	反动
江氏集团	反动
木仓	反动
20和谐年	反动
麻果丸	反动
抵制共产党	反动
一中一台	反动
zha弹	反动
taidu	反动
打倒江泽民	反动
清zhen	反动
自由门	反动
中共帝国	反动
霸餐	反动
江梳头	反动
自由亚洲	反动
希葬	反动
藏妇会	反动
南京军区	反动
江独裁	反动
boycott	反动
5月35	反动
无界浏览	反动
纽约时报	反动
duli	反动
min主	反动
粉碎四人帮	反动
占领台湾	反动
六四	反动
火药配方	反动
抵zhi	反动
抵制	反动
刘宾雁	反动
台湾版假币	反动
五毛党	反动
江系人	反动
西独	反动
特贡	反动
贰拾周年	反动
蒋捷连	反动
兵力部署	反动
灭共	反动
何清涟	反动
官逼民反	反动
满洲第三帝国	反动
陆肆	反动
中共权力斗争	反动
宪法修正案	反动
打倒共产党	反动
64时期	反动
腐败中国	反动
江胡内斗	反动
历史的伤口	反动
陈水扁	反动
台湾问题	反动
贪污腐败	反动
啦沙	反动
啦萨	反动
江派人马	反动
反分裂	反动
台完	反动
8341部队	反动
打倒朱镕	反动
台海大战	反动
炸弹配方	反动
baoluan	反动
硒藏	反动
示威	反动
日本万岁	反动
打倒中共	反动
新闻封锁	反动
宪法法院	反动
流血冲突	反动
youtube	反动
藏字石	反动
抵制朱镕基	反动
别梦成灰	反动
平反	反动
民竹	反动
坦克压大学生	反动
藏暴乱	反动
魏京生	反动
汉人	反动
美国广播公司	反动
民珠	反动
特供	反动
东突厥斯坦解放组织	反动
江黑心	反动
台湾国	反动
保钓组织	反动
中共解体	反动
解放台湾	反动
葬独	反动
台湾独立	反动
民进党	反动
西藏	反动
江贼	反动
中共党文化	反动
警匪	反动
东森新闻网	反动
中国时报	反动
zhadan	反动
王维林	反动
lasa	反动
baodong	反动
fenlie	反动
亢议	反动
刘晓竹	反动
宪章	反动
丹增嘉措	反动
打台湾	反动
藏m	反动
陈s扁	反动
石肖	反动
穆斯林	反动
公开信	反动
焚烧中国国旗	反动
中共裁	反动
高智晟	反动
江系人马	反动
真主	反动
东突解放组织	反动
五毛们	反动
哒赖	反动
苏贞昌	反动
江贼民	反动
阿扁	反动
世界日报	反动
双规	反动
陆四	反动
维基百科	反动
公头	反动
youxing	反动
满狗	反动
群体性事件	反动
统一台湾	反动
阎明复	反动
三硝基甲苯	反动
中国的陷阱	反动
东森电视	反动
组织集体	反动
罢参	反动
马英九	反动
抵制胡锦涛	反动
封锁消息	反动
军事社	反动
雪山狮子旗	反动
麻醉弹	反动
江宰民	反动
罢饭	反动
中共黑帮	反动
林文漪	反动
江核心	反动
中共邪教	反动
臧独	反动
爆zha	反动
江毒	反动
中国新民党	反动
江三条腿	反动
打倒共产主义	反动
台湾应该独立	反动
入联	反动
寻找林昭的灵魂	反动
沈彤	反动
di制	反动
中共的血旗	反动
藏民	反动
强制捐款	反动
中共恐惧	反动
苏晓康	反动
焦国标	反动
十7大	反动
藏毒	反动
主权	反动
援藏	反动
解放tw	反动
联名上书	反动
闹独立	反动
5毛党	反动
英国金融时报	反动
jing坐	反动
江泉集团	反动
学百度潮	反动
中共政治游戏	反动
tibet	反动
中共封网	反动
钓鱼岛	反动
太子党	反动
高丽棒子	反动
张志新	反动
皮箱炸弹	反动
收复台湾	反动
藏du	反动
严家其	反动
王超华	反动
人肉炸弹	反动
zha药	反动
打倒胡锦涛	反动
高勤荣	反动
王丹	反动
阿旺晋美	反动
反party	反动
湾台	反动
辛灝年	反动
吾尔开希	反动
记者无疆界	反动
成都军区	反动
藏西	反动
renquan	反动
中共近期权力斗争	反动
罢教	反动
王炳章	反动
六河蟹四	反动
抵制罗干	反动
贺卫方	反动
9学	反动
打倒罗干	反动
殃视	反动
西葬	反动
藏独	反动
08xz	反动
九风	反动
习仲勋	反动
人体炸弹	反动
台海问题	反动
低制	反动
江家帮	反动
2o年	反动
台独	反动
打砸抢	反动
回民	反动
支持台湾	反动
华盛顿邮报	反动
9风	反动
信访	反动
登陆台湾	反动
中华联邦	反动
权贵集团	反动
颜色革命	反动
油行	反动
炸dan	反动
中共邪毒素	反动
维汉	反动
官匪	反动
江氏家族	反动
无界网络	反动
麻醉狗	反动
64惨案	反动
伊斯兰	反动
六氟化铀	反动
清华帮	反动
08宪	反动
上海帮	反动
穆罕默德	反动
麻醉枪	反动
方励之	反动
藏春阁	反动
人拳	反动
毒豺	反动
贰拾年	反动
独夫民贼	反动
司马璐	反动
罢餐	反动
印尼屠华	反动
taiwan	反动
藏人	反动
红色贵族	反动
青天白日	反动
示wei	反动
罢课	反动
门安天	反动
bao炸	反动
集会	反动
支持zd	反动
万润南	反动
敏主	反动
中共退党	反动
官商勾结	反动
麻醉槍	反动
17da	反动
台军	反动
血洗京城	反动
党的喉舌	反动
江嫡系	反动
恐怖分子	反动
戒严	反动
江丑闻	反动
四风	反动
打倒中国	反动
藏青会	反动
专制政权	反动
国民党	反动
台百度湾	反动
江人马	反动
台海危机	反动
侯德健	反动
讨说法	反动
广州军区	反动
异议人士	反动
第21集团军	反动
济南军区	反动
中共腐败	反动
李天羽	反动
七大军区	反动
热比娅	反动
告全国同胞书	反动
天按门	反动
弓单	反动
xizang	反动
底制	反动
稀藏	反动
藏獨	反动
解决台湾	反动
最淫官员	反动
抗议	反动
去中央	反动
回回	反动
台湾有权独立	反动
天皇	宗教
基督教	宗教
车臣	宗教
天葬	宗教
古兰经	宗教
讲法	宗教
回教	宗教
观世音	宗教
基督	宗教
教徒	宗教
护法	宗教
达赖	宗教
大师	宗教
摩门教	宗教
天怒	宗教
功法	宗教
功友	宗教
潮喷	色情
ｇｕｉｌｄ ｗａｒｓ	色情
戳逼	色情
一本道	色情
黄色靠	色情
Apexsoft	色情
顶级学妹美穴淫图	色情
奸淫	色情
使劲插我啊	色情
法$侖	色情
muhon	色情
啊 啊 啊 好哥哥	色情
新手指導員	色情
遭警察殴打	色情
18dy粉红色高跟鞋	色情
品穴	色情
毛军事委员会	色情
草拟妈	色情
任建新	色情
溫家宝	色情
曰gM	色情
莎木online	色情
huan ling you xia	色情
妹妹的淫穴被龟头顶住	色情
操插GM	色情
167网址宽频影院网	色情
捅入妹妹的阴道	色情
肉棒深入花心	色情
法（輪）功	色情
美女出租车内强行进入	色情
張朝陽	色情
秘书的大乱交	色情
南蛮子	色情
韩日成人午夜激情电影	色情
皮条客	色情
毛江青	色情
盐酸二乙醯吗啡	色情
搶劫犯	色情
逼毛	色情
di qiu wen ming	色情
qi yu	色情
tum tum	色情
crazyspeed	色情
欧美成人帖图区	色情
肉棒插入乱伦射精	色情
MUGEN EX VOL 9 人体喷泉!强烈な潮吹きホール!(MX-09)	色情
免费淫色meimei电影	色情
神淚	色情
肉棒乱插 好舒服	色情
大鸡吧狠狠插进了她那又肥又嫩的小骚屄儿	色情
登辉	色情
rape	色情
看棋软件	色情
淫之学妹喷尿射得好高	色情
我淫我色网站	色情
mbs	色情
教你怎样延迟射精28岁以下禁免费淫电影a片	色情
大 紀 元	色情
激情淫穴	色情
淫奸jiejie小说	色情
阴茎被肉壁紧紧的夹着	色情
插入內射	色情
公審江澤民	色情
f**k	色情
淫奸姐姐小说	色情
日本淫色动画贴图	色情
offgamers	色情
法轮共	色情
SM援交	色情
d p p	色情
劍俠情緣	色情
毛小肉粒	色情
淫奸女护士	色情
淫女俱乐部	色情
王子杰	色情
中宣部是中国社会的艾滋病	色情
鹿城娱乐成人俱乐部	色情
手伸到儿媳妇下体抚mo嫩穴	色情
法**輪	色情
台湾18dy影院	色情
世界都	色情
fuck台湾民国	色情
洗脑	色情
江猪媳	色情
抽插31岁处女meimei淫叫不断	色情
巨乳女教師	色情
fuck退党	色情
严方军	色情
ｙｉｎｇ ｘｉｏｎｇ ｓｈｉ ｊｉ	色情
東突暴動和獨立	色情
你妈逼	色情
膣穴大陵辱 松岛	色情
喵的	色情
台灣豬	色情
荣誉之战I--钢甲洪流	色情
贱逼	色情
射进小穴	色情
发$$纶	色情
欠操	色情
GM001	色情
统独	色情
蒋彦永上书	色情
少妇淫乱小说	色情
服务天使	色情
小穴被大鸡巴插得好疼啊	色情
妹妹陰毛	色情
免费A片	色情
爱液	色情
fuck孙文	色情
本站10006多部激情电影全部免费试看三天	色情
heterosexuell	色情
fuck台湾共产党	色情
阳具插入小肉穴	色情
毛国土资源部	色情
操你妈靠	色情
勃起	色情
梓霖	色情
要射了	色情
51vip	色情
(現映社)女の最強は30代エロ真っ只中	色情
cha你	色情
张榕明	色情
fuck死全家	色情
女儿嫩穴操mm嫩穴操女人嫩穴	色情
色屋图片	色情
政治迫害	色情
猪毛	色情
陳曉寧	色情
操布雷尔	色情
毛塞你公	色情
插 9p	色情
瘟B	色情
傲视	色情
猛力的抽送大肉棒	色情
street of EROS 08	色情
肉棒抽出她嘴中	色情
毛台湾国	色情
毛斯大林	色情
反封锁技术	色情
热 站 政 论 网	色情
民阵	色情
亚洲激情淫电影	色情
创网	色情
ㄙㄞ你老母	色情
手指不断在肉穴扣弄	色情
发**沦	色情
李師付	色情
小穴夹着肉棒摩擦阴道	色情
icpcn	色情
女儿的阴道好嫩啊	色情
福呵定	色情
抽插27岁处女meimei淫叫不断	色情
下注	色情
又解开乳罩 ┅鸡巴	色情
kjking	色情
ｘｉｎｇ ｆｕ ｈｕａ ｙｕａｎ	色情
看中国	色情
干妈妈的小穴穴	色情
群奸亂交	色情
龟头 花心 骚屄	色情
發**掄	色情
超美女优MUGEN EX Vol。 7~浜崎ひめ	色情
台独靠	色情
屙	色情
群交亂舞	色情
火辣辣免费爽片	色情
xinsheng	色情
法论工	色情
顶级影片禁书禁图	色情
母子奸情	色情
手记注册日韩5014部激情电影	色情
毛日他娘	色情
操机掰	色情
成人色网	色情
制服诱惑	色情
ｌｉｈｏｎｇｚｈｉ	色情
Yellows Vol。2 女体天国 2 天然素人娘18人	色情
那吗逼	色情
Lateinos	色情
美幼专区	色情
ro	色情
日本帝國	色情
人民大会堂	色情
公务员调资	色情
1989#天安门	色情
悠遊網	色情
淫奸少女电影	色情
亚洲激情影院	色情
5jq	色情
成人社區	色情
乱伦熟睡的姐姐	色情
陈随便	色情
統	色情
免费淫奸女Ａ片段试看 少妇扒开阴道图	色情
出租汽车罢工	色情
韩 东 方	色情
吃屎	色情
集團熟痴女川奈-南智子-澤宮有希-櫻田由加里4時間	色情
成人午夜激情聊天室	色情
bxqt	色情
fuck吴　仪	色情
肉棒顶到花心	色情
meimei　MM激情	色情
gangbang	色情
郑万通	色情
淫乱色情小说	色情
張震	色情
父女激情淫色	色情
奸杀meinv大学生	色情
郭岩华	色情
广安第二人民医院	色情
插 6p	色情
英雄世纪	色情
默克尔	色情
牲口	色情
法纶	色情
亚洲淫穴电影	色情
疯狂jiejie淫穴	色情
天使之恋	色情
六四參加者	色情
联 总	色情
膏藥旗	色情
四清	色情
免费成人娱乐電影	色情
夜色聊人	色情
無碼絲襪	色情
毛身份生成器	色情
日本激情片	色情
性傭	色情
法@@纶	色情
聚商	色情
少妇房中自淫，和两勇男玩15P，操得直叫爽 操日本淫女穴	色情
完全免费淫电影	色情
鮮族	色情
插淫屄	色情
免费淫奸女Ａ片段试看 处女第一次阴道做爱全过程(全套图片)	色情
操插深些	色情
龙虎	色情
华西列夫斯基	色情
系統管理員	色情
神通加持法	色情
保钓	色情
meinv野兽做爱淫图	色情
六决不	色情
妹妹的嫩屄	色情
ｔｅｎｇｒｅｎ	色情
雞八	色情
陰戶	色情
色猫情色论坛	色情
死亡人数	色情
人美乳甜屄嫩操起来真爽	色情
朱可夫元帅	色情
人妻交換	色情
色站导航	色情
法論	色情
黄色影视	色情
成人BT	色情
疯狂抽插她的小穴	色情
色情信息	色情
jinyong	色情
狂插淫穴淫水	色情
毛僵贼民	色情
完全免费在线淫电影 看完保证你打飞机	色情
jushang	色情
新江湖Online	色情
插烂妹妹小屄	色情
戀愛盒子	色情
走向圓滿	色情
热站政论网	色情
插妹妹小穴	色情
贱	色情
郭盈恩挑战性交吉尼斯(对256男)直播全记录	色情
阳痿	色情
fuck私/服	色情
抽插21岁处女妹妹淫叫不断	色情
ｍｉｒ3	色情
射雕淫女传9	色情
免费淫电影a片。母子淫*乱轮现场看扶正肉棒	色情
剑网3	色情
meimei乱伦理淫穴	色情
欧美无套	色情
T浓厚中出FUCK Red Hot Fetish Collection Vol。44 : 夏川Saya	色情
大 史 記	色情
捐款名單	色情
都江堰	色情
激爱贴图 加西激情中文网	色情
三陪	色情
99Baby Sana Okada in Maid	色情
lihongzhi	色情
淫贱meimei贴图论坛	色情
精液榨取	色情
性交课	色情
nigger nigger	色情
肉棒肉洞 肉缝	色情
迷人阴部护士meimei也疯狂	色情
草	色情
流淫	色情
强制执行 女体崩壊~1	色情
ㄙㄞ你老师	色情
嫩穴美女挖嫩穴淫女嫩穴俱乐部	色情
又嫩又紧的屄	色情
毛鸡巴	色情
毛计生委	色情
中机电	色情
傻子	色情
肉唇	色情
扒开她的小穴穴	色情
她的阴道好深啊	色情
那媽	色情
火辣图片	色情
操插你	色情
干小蜜洞	色情
女乃	色情
成人激情电影	色情
法谪功	色情
疯狂赛车	色情
色书库	色情
哥哥的肉棒好大	色情
MM的诱人双峰	色情
xin shi qi	色情
丫的	色情
操比毛	色情
你妈比	色情
愛滋病	色情
毛賊東	色情
本站10021多部激情电影全部免费试看三天	色情
sw2	色情
高潮	色情
宁王府成人	色情
免费性爱电影	色情
弟弟的肉棒好硬啊	色情
激情淫穴小说	色情
舔脚	色情
爸爸	色情
轮流干	色情
法$仑	色情
避孕套	色情
18dy淫色贴图	色情
大鸡巴小浪穴	色情
爆乳人妻	色情
日逼	色情
激情淫色动画片	色情
瓜婆娘	色情
少林传奇	色情
免费成人图片 色情美女做爱美女小穴写真	色情
天骄	色情
又粗又硬的肉棒	色情
熟妇骚器	色情
操吃屎	色情
經血	色情
法@@倫	色情
妈……你的小穴好插	色情
18淫书	色情
美国成人激情淫洞网站	色情
血洗天安門	色情
一股滚热的精液从插得紫红的龟头马眼里激射而出	色情
河 殇	色情
7hero	色情
Mix Studio Vol。 7女医	色情
穿著PE校服	色情
金瓶梅	色情
meinv做爱激情电影	色情
她奶奶的	色情
淫乱电影	色情
毛发论	色情
错b	色情
少女免费激情电影	色情
ｖｕｌｖａ	色情
bb论坛 操bb图	色情
毛孙文	色情
肉棒好粗 插	色情
肉棒顶入小穴口	色情
騷比	色情
巨骚	色情
成人聊天室	色情
插 8p	色情
賣軟體	色情
fofg妈的	色情
人民代表大会	色情
白立忱	色情
和两勇男玩50P	色情
棒阴道好痒痒	色情
蔓ぺ	色情
東亞病夫	色情
布莱德雷	色情
哥哥插入我的小穴	色情
1989 天安门	色情
彭德怀	色情
肉棒插进肉洞里	色情
遗忘传说	色情
ｊｂ	色情
處女開包	色情
毛鸡奸	色情
搔meimei黄站	色情
操逼样	色情
插我 用力插 好爽	色情
弟弟粗大的肉棒	色情
操王	色情
香港成人电影网	色情
blowjobs	色情
Arisa Kumada	色情
私%服	色情
用骚痒难捺的阴部淫荡地摩擦着粗壮的鸡巴	色情
新浪	色情
liu xing hu die jian	色情
地震	色情
仙劍	色情
service	色情
盗撮	色情
黑马@SQ Evolution Vol。3 柳濑遥	色情
阴蒂	色情
徐建国案件	色情
嘉联	色情
成人夜话	色情
本站10022多部激情电影全部免费试看	色情
狂风暴雨	色情
ㄙㄞ你爸	色情
奴隶调教	色情
鸡巴对准柔软的阴肉缝沟	色情
kart	色情
一夜情的免费电影	色情
日韩成人电影	色情
大肉棒干我的小穴和屁眼	色情
美女主持25小时全天激情热舞	色情
变态	色情
日X 妈	色情
YGBH	色情
1８歲淫亂	色情
总裁	色情
學生愛國運動正名	色情
法*論	色情
育碧	色情
魔性的美女 鈴木麻奈美	色情
救災	色情
强*十八岁meinv护士 看完保证你打飞机	色情
又鸟女干	色情
毛警匪一家	色情
ｓａｎ ｇｕｏ ｑｕｎ ｙｉｎｇ ｚｈｕａｎ	色情
Kamikaze Girls Vol。29 : Arisa Suzufusa	色情
BT成人无码	色情
毛疆独	色情
TokyoHot之极品meimei	色情
反社会	色情
美女激情视频聊天室	色情
雞吧	色情
pp点点激情片播放	色情
蜜穴贴图	色情
卖。国	色情
┷	色情
三八淫成人网	色情
龟头挤进了jiejie的小穴	色情
林心如特级片	色情
制服古典乱伦都市	色情
成人18免费电影	色情
情色俱乐部meinv奸淫。黄色电影裸体电影PP点点激情电影	色情
爱的奉獻	色情
费良勇	色情
山口组	色情
淫女乱伦小说	色情
肉棒插入阴户	色情
drop	色情
龟头插小穴	色情
姘頭	色情
网管	色情
濫交	色情
潮吹	色情
大航海时代	色情
meinv护士被奸	色情
复员	色情
新絕代雙驕	色情
旅館自拍	色情
不用注册淫电影网站	色情
造愛	色情
妹妹	色情
i n c e s t	色情
黄色小电影	色情
６。４	色情
毛卖号	色情
欢城	色情
发**论	色情
龟头插入肉縫	色情
共榮圈	色情
火辣寫真	色情
counselor	色情
色网阴道特写强奸33岁处女全过程	色情
强奸meinv	色情
丁石孫	色情
现役看护妇	色情
龚學平	色情
ｔｉａｎ ｚｈｉ ｙｏｕ ｘｉａ	色情
激情少妇	色情
三K黨	色情
６１０办公室	色情
穴图	色情
9you	色情
毛国资委	色情
掛機	色情
阴茎插小穴	色情
夜夜色大型黄站	色情
ｇｕｎ ｇｕｎ ｑｉｕ	色情
激情淫色视屏	色情
福摩薩	色情
肏妹妹的小骚屄	色情
成人情色导航	色情
你他妈的	色情
国家领导人	色情
亚洲激情淫色贴图	色情
肛交	色情
香港激情淫色区	色情
一貫道	色情
創意鷹翔	色情
53xp。com 电影免费	色情
万维读者论坛	色情
亚洲黄站	色情
粉红的的奶頭粉嫩的阴唇	色情
保证你打飞机	色情
鬼轮奸	色情
globalrescue	色情
美女极品嫩穴	色情
禽獸	色情
庆红	色情
ｃｈｉ ｌｏｎｇ ｊｉａｎ ｘｉｎ	色情
毛公安	色情
抽插35岁处女妹妹淫叫不断	色情
婊子靠	色情
三p	色情
李维汉	色情
trannie	色情
程凯	色情
非常三国	色情
jiejie和我乱伦理小说	色情
ｋｅｌｅ8	色情
激情淫色贴图区	色情
busterd busterd	色情
自杀手册	色情
华夏Online	色情
和两勇男玩3P	色情
mland	色情
ｒｅ ｘｕｅ ｙｉｎｇ ｈａｏ	色情
刚比样子	色情
刘延东	色情
阴阜高耸	色情
插GM	色情
戴维教	色情
淫色电影	色情
ｗｕｌｉｎ2	色情
国安局	色情
邓 笑 贫	色情
免费妹妹黄色淫乱	色情
陈军	色情
抽Ｂ淫穴	色情
新闻出版署	色情
龙虎豹	色情
军长发威	色情
九城	色情
Ezgaming	色情
姐姐和我乱伦理电影	色情
新聞出版署	色情
bt免费淫电影下载	色情
素人之中的极品漂亮妹	色情
监察部	色情
肉棒 ……好舒服喔	色情
干gM	色情
豆豆秀	色情
小嘴吞吐的肉棒	色情
午夜激情美穴贴台湾性福联盟	色情
多維週刊	色情
叫床	色情
僕街	色情
毛穴贴图	色情
ｔｍｄ	色情
那娘错比	色情
成人影视	色情
國賊	色情
淫荡 空姐	色情
田紀雲	色情
毛敬国神社	色情
奴隷女教師－女尻狩り　吉野あゆみ	色情
狗養	色情
儿届中央政治局委员	色情
阴沟	色情
无毛穴	色情
刘文胜	色情
和姐姐肏屄	色情
口含龟头	色情
fuck天安门档案	色情
皇軍	色情
毛他妈的	色情
成人激情淫穴影院	色情
nana无修正AV女优ハメ撮り	色情
痴meinv醫生松島	色情
月經	色情
遊戲蝸牛	色情
如来	色情
操78	色情
pet520	色情
六四之前	色情
總書記	色情
44xp。com 电影免费	色情
超级舞者	色情
发廊性息	色情
MM被干小穴	色情
game MASTER	色情
李小朋	色情
鹽酸二氢埃托啡	色情
陰部特寫	色情
我操	色情
回族人吃猪肉	色情
肉棒插入子宫	色情
safeweb	色情
肉棒的抽插…。好爽	色情
挺送 肉棒 激烈 撞击	色情
鸟g M	色情
日本小泉	色情
太监	色情
淫 电影	色情
亞洲情色網	色情
爱因斯坦	色情
童顏巨乳	色情
去他妈	色情
幸福花园	色情
开苞	色情
Ｂ	色情
卖财富	色情
搔穴自慰	色情
姐姐的肥阴户	色情
操B	色情
极品黑丝	色情
在线小淫虫电影	色情
幻靈遊俠	色情
Groove Party	色情
無網界流覽	色情
dou dou	色情
夜情	色情
法~~淪	色情
色狼论坛	色情
亲情淫乱	色情
操他妈	色情
淫蕩 大雞巴 嫩穴	色情
365淫色贴图	色情
2。23會議	色情
台獨	色情
務	色情
央视内部晚会	色情
威而钢	色情
洗脑班	色情
高速下載!	色情
毛客服	色情
山本五十六	色情
大j8	色情
抽插32岁处女meimei淫叫不断	色情
人大代表	色情
ggol	色情
ｘｉｎ ｊｉａｎｇ ｈｕ	色情
王太華	色情
温B	色情
妈个老比	色情
你二大爷	色情
新任教师の淫行物语	色情
22dy淫色贴图	色情
唐人互动	色情
抽插51岁处女妹妹淫叫不断	色情
色女脱衣秀	色情
嫩逼 淫水	色情
远程偷拍	色情
姦淫	色情
和jiejie淫穴	色情
免费淫 电影a片	色情
周六性吧	色情
智凡迪	色情
濕身誘惑	色情
荡女	色情
瑞士金融大学	色情
抽插29岁处女妹妹淫叫不断	色情
亚洲免费黄网	色情
自由亞州	色情
激情裸聊	色情
淫电影下载论坛	色情
情色六月天 人间仙境情色网	色情
日你妈啦逼	色情
东热空姐	色情
苯甲醯甲荃芽子堿	色情
烂屌	色情
狂插护士穴	色情
免费成人A片	色情
U/R靠	色情
水去車侖	色情
毛日你	色情
日本美女鲍鱼贴图区	色情
想插穿她那肥嫩的小骚屄儿	色情
幼女开雹	色情
luanshi	色情
墨香	色情
毛农业部	色情
身寸米青	色情
靠背	色情
陈希同	色情
少妇房中自淫，和两勇男玩19P，操得直叫爽 操日本淫女穴	色情
天安門慘案	色情
圓满	色情
传奇3G	色情
溫總理	色情
厕奴	色情
洞抽少妇	色情
河 殤	色情
肉茎	色情
逼孕	色情
滾那嗎瘟比	色情
性学教授	色情
┅插┅小穴 肉缝	色情
干x娘	色情
成人影視	色情
插穴图	色情
所盗摄护士姐姐性感美腿图 肉丝美腿艳情淫欲	色情
mo擦小肥穴	色情
阎安	色情
东热RQ大乱交2007	色情
┅舒服死大鸡巴插	色情
口味稍重 CD2	色情
弟弟的肉棒好粗	色情
免费看三级电影淫电影艳情电影	色情
嫩穴里他的鸡巴	色情
六四民運	色情
sofben sofben	色情
抽插到高潮	色情
免费黄色淫乱电影	色情
比样	色情
李師父	色情
人权	色情
操日本淫女穴	色情
和阿姨玩插穴游戏	色情
赛福鼎•艾则孜	色情
問道	色情
和少妇做爱好爽	色情
天安門殘案	色情
meimei的小阴户	色情
六四点击	色情
MUGEN EX Vol。4	色情
淫液沾满阴道	色情
自由民主论坛	色情
骑她	色情
fuck无界浏览器	色情
中公网	色情
18dy大众成人网	色情
宋美龄	色情
尸体	色情
免费激情视频聊天室	色情
天地玄門	色情
jiejie的阴户	色情
日韩成人激情电影	色情
红宝石	色情
李瑞環	色情
残忍的虐待强奸美丽的淑女	色情
王涵万	色情
作ai	色情
gM	色情
腾仁	色情
抠穴	色情
粗大的龟头	色情
骯髒美學	色情
陰蒂	色情
孫逸仙	色情
帕巴拉•格列朗杰	色情
機八	色情
淫洞	色情
毛廁洞	色情
朱狨基	色情
那嗎逼	色情
舌头舔小肉缝	色情
fuk	色情
snk。ni8。net	色情
fuck私—服	色情
我草	色情
高岗	色情
李沛瑶	色情
FUCK	色情
毛傻卵	色情
黃片	色情
71776	色情
狗幹	色情
fuck我日你	色情
fuck神通加持法	色情
恶搞晚会	色情
肉逼	色情
全免费淫电影	色情
中華民国	色情
亚洲淫影院	色情
毛色情电影	色情
穴	色情
fuck賣．國	色情
淫虐	色情
你她马的	色情
超淫荡丝袜妹妹	色情
陰核	色情
成人午夜激情电影	色情
毛文物局	色情
小幼女开处清晰大图	色情
新诗年鉴	色情
插阿姨的洞洞舔女朋友的下身	色情
十景缎	色情
政变	色情
阴茎被小穴紧紧包住	色情
毛刘少奇	色情
大鸡吧在小穴内壁摩擦	色情
媽的B	色情
江泽民靠	色情
菜b	色情
92bb成人小电影	色情
輪功	色情
欲火焚身	色情
強姦	色情
毛妈的	色情
粉嫩淫臀	色情
狂插meimei的小穴	色情
我也要泄了	色情
黑白无常	色情
淫漿	色情
饿比	色情
林心如被疯狂轮奸	色情
搔meimei色站大全	色情
奴畜抄	色情
操产权局	色情
ｇｏｎｇ ｆｕ ｘｉａｏ ｚｉ	色情
处女淫水图台湾女人裸	色情
插小穴的快感	色情
hdw	色情
毛马英九	色情
亚洲激情成人电影	色情
騷妹妹	色情
神話R。Y。L	色情
娘b	色情
盐酸二乙酰吗啡	色情
中华时事	色情
肉棒插入大肉穴	色情
啊……阿姨要洩了……	色情
紧窄的洞口只能含进半个龟头	色情
強制浣腸	色情
成人免费黄电影	色情
监管	色情
金酷	色情
毛邪教	色情
扎卡维	色情
奶子	色情
毛手机复制	色情
(Tokyo Neko) Tokyo Neko GN Vol。1 Ibuki XVID+Ogg	色情
死GD	色情
小嫩鸡	色情
无需手机注册激情电影	色情
日本激情淫色下载	色情
就去誘惑	色情
救援	色情
百家性大型黄站	色情
毛喷你	色情
人民内情真相	色情
肏	色情
电视流氓	色情
毛四川独立	色情
菊花蕾	色情
我就色	色情
BlowJobs	色情
肉摩擦她处女的肉穴深处	色情
手记注册日韩5020部激情电影	色情
百家性大型bt黄站	色情
午夜激情宽频影院	色情
Obama	色情
如果你未满27周岁请自觉离开。	色情
ｍａｋｅｌｏｖｅ	色情
fuck王乐泉	色情
计生委	色情
刘晓波	色情
毛丫的	色情
黑省副省长	色情
干阿姨的骚穴	色情
赌马	色情
捏你鸡巴	色情
颜骑	色情
幹ＧＭ	色情
外/挂	色情
淫奸少妇穴	色情
视频自拍	色情
毛网管	色情
ｑｉａｎｇｊｉａｎ	色情
1989 天安門	色情
全球华人春节联欢晚会	色情
淫棍	色情
小姨子的阴道好紧啊	色情
又粘又湿的阴户	色情
狂插阿姨穴	色情
本站10018多部激情电影全部免费试看	色情
骚比	色情
大麻树脂	色情
阴道好紧啊	色情
淫电影//少妇扒开阴道图-淫賤少女阴唇特写图	色情
韩国成人激情淫洞	色情
毛联合国大会	色情
李鹏	色情
虎虎虎~ Tora-Tora Platinum Vol。2 : 魔性的美女 鈴木麻奈美	色情
舔她的花蕊	色情
滕文生	色情
ｍａｋｉｎｇｌｏｖｅ	色情
淫B浪女	色情
十八摸	色情
靠你妈	色情
meimei的穴好多水	色情
三夫妻结伴旅游换妻大乱交	色情
学生爱国者运动证明	色情
林心如做爱网	色情
粉红色的小嫩逼淫	色情
成人爽电影网站	色情
强奸30岁处女全过程/淫妹阴毛小穴	色情
无毛美少女	色情
人妻交换	色情
freenet	色情
毛meimei免费电影	色情
台湾成人22贴图	色情
6月4日	色情
春光外瀉	色情
紧穴	色情
巡查员	色情
……好粗…好舒服	色情
我含住他的阴茎	色情
免费淫奸黄色电影	色情
新观察论坛	色情
法~仑	色情
陽萎	色情
於天瑞	色情
肉棒插入少妇嫩穴	色情
受精	色情
歐美大乳	色情
發~淪	色情
成人午夜激情	色情
混沌	色情
热比娅	色情
meimei等你大鸡吧来插	色情
Lady Sonia-熟女丝袜 13	色情
jx2	色情
李弘志	色情
毛毛一鲜	色情
大波粉B	色情
免费在线淫电影网站	色情
再用力插…。啊	色情
肏屄	色情
網易	色情
jian你	色情
毛李弘旨	色情
银行账號	色情
把我的穴插烂了	色情
穿豹紋的meinv，很有野性美。看她咬著肉根就可看出來。	色情
手机注册色情电影网站	色情
近亲相奸	色情
陸肆	色情
在线淫电影，免费淫色情电影	色情
流亡	色情
毛干Gm	色情
新四	色情
少年阿宾	色情
外\掛	色情
浪穴 肉缝 嫩穴	色情
阴茎被火热而湿润的阴道所包含着	色情
淫妇周艳茹和儿子的性战	色情
赣您娘	色情
墮淫	色情
賣党求榮	色情
香港成人淫电影	色情
耣	色情
本站的免费成人电影	色情
毛蒙古达子	色情
六四參加者回憶錄	色情
mir3	色情
ｊｉｎｇ ｔｉａｎ ｄｏｎｇ ｄｉ	色情
洪兴	色情
幼香閣	色情
thsale	色情
毛新华社	色情
fuck新闻管制	色情
淫荡少妇激情自拍 成人激情	色情
血灑天安門	色情
复制	色情
毛发论公	色情
淫女老师	色情
東突	色情
人民报	色情
【亚洲/无码】【生奸中出无套内射-相沢、夏樹、 美月遥】【AVI/1220MB】	色情
tampon	色情
你把妈的穴穴插满了	色情
肉棒用力的抽插着小阴唇	色情
它媽的	色情
lovebox	色情
洪 吟	色情
ｇａｎｇ ｊｉａ ｈｏｎｇ ｌｉｕ	色情
法论共	色情
发^沦	色情
毛新唐人	色情
她的阴道好紧	色情
CREATE	色情
メイド召しませ 第一话	色情
辦公室淫亂	色情
飄流幻境	色情
萬里	色情
搜神记	色情
张 伯 笠	色情
用手指分开两片肥嫩的阴唇	色情
香港激情淫电影	色情
鸡巴插小穴	色情
網捷信	色情
(Madonna) 熟女義母 11套 AVI	色情
李洪志	色情
精液射如妈妈的穴	色情
淫荡女优放荡插逼	色情
淫电影//现场强奸18岁处女扒开小穴清晰做爱阴道裸体图	色情
冰風傳奇	色情
色情論壇	色情
色狐狸网址	色情
earthciv	色情
100bb成人小电影	色情
ｃａｏｂｉ	色情
天安們母親運動	色情
湿淋淋的骚阴道	色情
曾 慶 紅	色情
ｈａｎｇ ｈａｉ ｓｈｉ ｊｉ	色情
免費偷窺網	色情
菊花洞	色情
阴穴新玩法	色情
淫图新社区	色情
谭绍文	色情
博白县	色情
我和少妇	色情
毛看牌软件	色情
扮开嫩穴	色情
塔利班	色情
滿洲國	色情
嫩B	色情
性器	色情
風豔閣	色情
押小	色情
佛祖	色情
法**沦	色情
肉棒的抽插 ……啊	色情
做爱	色情
干炮	色情
钻插	色情
绵陽	色情
好爽	色情
台湾身材一流美女楼梯性爱	色情
毛塞白	色情
F_U_C_K	色情
米田共	色情
法**仑	色情
朝鲜	色情
大鸡吧操小逼	色情
hellgate	色情
插你妈	色情
傻B	色情
駛你爸	色情
抽插46岁处女妹妹淫叫不断	色情
淫賤	色情
靠	色情
hardcore	色情
自拍写真	色情
日B	色情
台湾总统	色情
日本激情免费小电影	色情
大龟头顶住花心	色情
维权	色情
将肉棒插在阴道里面	色情
99bb成人小电影	色情
下身	色情
毛司法部	色情
又硬又大的肉棒	色情
十八岁禁入电影	色情
法@@淪	色情
日本激情淫影片下载	色情
操大东亚共荣	色情
華夏Online	色情
肥嫩的小骚屄儿阴部	色情
天天免费成人	色情
赵海青	色情
麻醉药	色情
偷情 乱伦	色情
周子玉	色情
毛鸦片液	色情
購金	色情
百家性大型黄站网址	色情
f u c k	色情
我日	色情
法@侖	色情
婷婷激情俱乐部	色情
亮屄	色情
干汝	色情
4。25	色情
shit	色情
無碼彩圖	色情
全 國 兩 會	色情
笨蛋	色情
好嫩的屄啊	色情
suck你妈的	色情
輪奸內射	色情
GMworker	色情
李红志	色情
蠢猪	色情
成人电影网站	色情
干少妇小穴	色情
chinesenewsweek	色情
龟公	色情
台湾共和国	色情
大纪元	色情
大龟头顶住嫂嫂的花心深处	色情
践踏中国女性	色情
毛傻比	色情
口圭	色情
ｊｉｂａ	色情
粉嫩小淫穴	色情
苯環利啶	色情
搏客Online	色情
chuan qi	色情
淫丝荡袜	色情
ｘｉａｎ ｊｉｅ ｚｈｕａｎ	色情
免费在线观看 免费淫奸女Ａ片段	色情
renminbao	色情
她的阴道乳房真美	色情
午夜情色电影	色情
插入穴爽死了	色情
肛门潮吹 极太合体 原千寻 红音 桜田	色情
操车仑	色情
集體性愛	色情
血逼	色情
Himiko 010 Riko Kurusu 来栖! 中出	色情
舌头舔进阴道	色情
俏臀攝魄	色情
你的小穴好温暖…	色情
美女口含鸡吧玩内射	色情
張宏堡	色情
和两勇男玩10P	色情
中国军用运输机	色情
龍與地下城	色情
极品做爱套图	色情
血灑	色情
法~抡	色情
激情玩穴网	色情
大众色情成人网	色情
成人 性爱	色情
发@伦	色情
嫩鮑	色情
張 昭 富	色情
和两勇男玩13P	色情
家庭乱伦	色情
魔兽金币	色情
fuck田纪云	色情
妈个b	色情
情色电影网站	色情
tester	色情
淫荡妈妈之办公室助理	色情
毛鸠屎	色情
亞洲淫图	色情
毛温加宝	色情
淫民激情文学图库欣赏	色情
值勤账号	色情
bitch	色情
dh315	色情
学生妹美女在野外偷情	色情
epochtime	色情
淫奸电影少妇扒开阴道	色情
深爱色色	色情
佈雷爾	色情
輪	色情
姐都快被你搞死了	色情
脱衣舞	色情
劳教	色情
亚/无码	色情
大鸡吧插妹妹	色情
联通移动秘密通道	色情
法*论	色情
ｐｉａｏ ｌｉｕ ｈｕａｎ ｊｉｎｇ	色情
东亚	色情
transsexual	色情
僵贼	色情
阿沛•阿旺晋美	色情
侠客天下	色情
日本成人激情影院	色情
韩启德	色情
bt	色情
续金瓶梅	色情
信息	色情
無碼	色情
法**论	色情
升达	色情
毛李红志	色情
BT无码区 激情电影	色情
應招	色情
雞巴	色情
濫比	色情
江獨裁	色情
操女人嫩穴	色情
兒屆中央政治局委員	色情
淫樣	色情
要色色	色情
儿子淫奸jiejie穴	色情
快操我快操我的小B电影	色情
helbreath	色情
一九八九年六月四日	色情
免费黄色电影/色情电影/激情电影/黄色电影/我该死/A片	色情
含 肉棒 插 小穴	色情
MM激情视频聊天	色情
ci77	色情
龟头粗壮赤红	色情
ｗｅｎ ｄａｏ	色情
快乐到死	色情
轻轻地抽插著阳具	色情
激情淫色贴图网	色情
舔屁眼	色情
倪志福	色情
插入……大肉棒	色情
家庭主妇 翔田千里 志村玲子	色情
群p	色情
私立淫乱学园 完全版(中文字幕)	色情
前网	色情
Bao皮	色情
ｒｅ ｘｕｅ ｊｉａｎｇ ｈｕ	色情
黃色漫畫	色情
猶太豬	色情
cunt	色情
发^^仑	色情
死亡人數	色情
打倒中华人民共和国	色情
法**伦	色情
灨你娘	色情
放荡少女少妇	色情
白莲教	色情
騷浪人妻	色情
sb	色情
运营人	色情
抽插23岁处女meimei淫叫不断	色情
舔舔私处meimei嗷嗷叫	色情
淫汁	色情
淫奸妹妹电影	色情
毛升达毕业证	色情
丝袜高跟	色情
┺	色情
免费淫色强奸电影	色情
布希	色情
21dy淫色贴图	色情
温家宝	色情
ｓｈａｉｙａ	色情
淫奸处女穴论坛	色情
回民吃猪肉	色情
阴唇 口含鸡巴	色情
法*倫	色情
法轮大法靠	色情
淫肉诱惑	色情
老少乱伦	色情
名人大道	色情
地下教会	色情
18dy免费观看	色情
魅惑巨乳	色情
嫖妓指南	色情
狂插meimei穴 淫水流	色情
淫荡 穴 淫洞	色情
毛干妳	色情
操神	色情
大肉棒插进了她的体内	色情
builtfree。org	色情
干骚女	色情
中华讲清	色情
性奴会	色情
圣女峰	色情
打手槍	色情
ＵＲ靠	色情
嫩穴meinv挖嫩穴淫女嫩穴俱乐部	色情
淫色影院	色情
102bb成人小电影	色情
肉棒进入肉洞	色情
帕巴拉•格列朗傑	色情
我和小少妇乱伦理淫穴	色情
毛硬挺	色情
淫水漣漣	色情
迷藥	色情
毛蒋中正	色情
又长又大的肉棒	色情
红十字會	色情
蒙独	色情
淫水流出图强*免费淫电影	色情
和两勇男玩23P	色情
舆论	色情
穴圖	色情
张 昭 富	色情
龟头狂插肉洞	色情
精水	色情
毛江Core	色情
帝國主義	色情
護士誘惑	色情
芬太尼	色情
航海世纪	色情
劲暴	色情
爱滋	色情
用手指分开两片肥嫩的阴唇，露出了那娇小鲜嫩的小屄洞	色情
免费女Ａ片段	色情
公安	色情
北极冰	色情
于大海	色情
追查国际	色情
草你娘	色情
文物局	色情
少妇穴	色情
毛新义安	色情
成人网我该死免费视频	色情
法**轮	色情
龍陽	色情
插暴	色情
肉棒在乳沟来回猛抽	色情
迷魂药	色情
昝爱宗	色情
d7se	色情
秦青的幸福生活	色情
乱伦之淫穴网	色情
唐家璇	色情
立花里子のレズビアン母乳M女コレクション	色情
国务院	色情
ｊｉｎ ｙｏｎｇ ｑｕｎ ｘｉａ ｚｈｕａｎ	色情
89暴乱	色情
大龟头顶住了她的花心深处	色情
民主墙	色情
淫語痴女性欲	色情
江湖 淫娘	色情
小屄儿里又暖又紧	色情
吗逼	色情
劍網2	色情
毛鸡八	色情
亚洲激情影院论坛	色情
氵去	色情
ju shang	色情
Barefoot Confidential 46	色情
中機電	色情
鸡巴插进小穴	色情
淘宝	色情
ｓｔｏｎｅａｇｅ	色情
淫屄儿	色情
免费淫水流	色情
发$抡	色情
獸交	色情
黑鮑娇	色情
台湾情色網	色情
64yl	色情
插 5p	色情
鸡巴插进了的小穴	色情
ｔｉａｎ ｊｉａｏ	色情
换妻大会	色情
多维	色情
梵高	色情
不良少女日记	色情
毛妹妹免费电影	色情
女干	色情
毛透视软件	色情
狗乘	色情
幹你	色情
毛国防科工委	色情
操插gM	色情
中国社会论坛	色情
親 日	色情
fuck王宝森	色情
國家領導人	色情
如果你未满21周岁请自觉离开。	色情
新义安	色情
港澳办	色情
丁字裤	色情
大史	色情
狂操 插 干 老板娘	色情
張萬年	色情
好嫩	色情
feng kuang sai che	色情
毛干七八	色情
美仙子 美乳+美腳 天中梨子	色情
毛虐待	色情
淫图淫片全部免费	色情
a$shole	色情
市長	色情
少妇偷情	色情
好朋友	色情
免费电影妖艷醫生	色情
剛癟三	色情
台湾黄色成人电影	色情
熟女网爱记	色情
倚天屠龙别记 殷素素	色情
外？掛	色情
毛恐怖主义	色情
ＧＹ	色情
∪R	色情
meinv潮吹	色情
內衣	色情
〓成人写真〓	色情
大奶骚女	色情
轮功	色情
吴 方 城	色情
日本顶级淫女	色情
黄克诚	色情
fuck是鸡	色情
po tian yi jian	色情
李大師	色情
mythos	色情
天上碑	色情
淫穴 大鸡巴干 好爽	色情
双峰微颤	色情
ｓｂ	色情
大 纪元	色情
智冠	色情
南联盟	色情
partita	色情
你老妹	色情
妈妈帮儿子套动着	色情
…太爽了…大鸡巴	色情
西藏問题	色情
偷操嫂嫂	色情
聖母	色情
法*轮	色情
步非烟	色情
干你妈B	色情
大鸡巴就慢慢的插入 小穴	色情
龟头喷射出浓浓的精液	色情
抽插26岁处女妹妹淫叫不断	色情
暴動	色情
罗　干	色情
毛鬼村	色情
日本成人激情淫穴	色情
歡樂性今宵	色情
日你老母	色情
性欲	色情
成人激情视频聊天室	色情
肉丝裤袜	色情
精液射入了她的体内	色情
台湾18黄网亚洲华人bbs性论坛	色情
床上激情淫乱小搔穴	色情
無碼淫女	色情
麦司卡林	色情
ｚｈａｎ ｇｕｏ ｙｉｎｇ ｘｉｏｎｇ	色情
淫电影//教你如何鉴别处男处女的方法(组图)18岁禁看	色情
手指抠肉洞 肉缝	色情
tw18	色情
teen sexy	色情
及びタイトル ？(Calen)セーラー服とマシンガン 柚木ティナ	色情
大唐豪侠	色情
美女淫图	色情
淫色导航	色情
slanglist	色情
独占动画~潮崎~高校女教师陵辱1+2	色情
日本免费黄站	色情
喷雾型迷药	色情
朱镕基	色情
三国群英传OL	色情
免费免注册在线看电影	色情
淫东方	色情
窃听器材	色情
陈水扁	色情
小淫女	色情
审计署	色情
林伟	色情
熊焱	色情
１６大	色情
TeSt	色情
何加栋	色情
溫泉室的男女	色情
李淑娴	色情
出售神符靠	色情
肉棒已经整根插入穴中	色情
妹妹的屄	色情
淫荡家教	色情
公车淫奸meimei	色情
李 总 统	色情
免费淫奸女Ａ片段试看 欢迎点击进入观看/林/心如/20岁处女偷拍	色情
馒头屄	色情
亚洲淫图	色情
淫蜜	色情
狗日靠	色情
劲樂	色情
淫奸电影 淫色猎暴淫电影 射雕淫女传 风骚小龙女 meinv淫女图-小龙女淫女俱乐部影 在线淫电影	色情
手指拨弄着穴口	色情
婷婷口含鸡巴	色情
淫奸女教师穴	色情
欧美做爱	色情
海天英雄傳	色情
毛奶子	色情
wg	色情
情色成人视频聊天室	色情
弟弟摸姐姐胸部小说	色情
母奸	色情
奸他	色情
劍俠情緣II	色情
操你妈屄	色情
毛基督教	色情
刘永川	色情
又硬又大的肉棒插入阴户	色情
插少女阴道	色情
小骚屄儿妹妹	色情
瘪三	色情
八 仙	色情
淫民堂	色情
妹妹美图网	色情
激情人体18禁	色情
亚洲情色套图	色情
蔣彥勇	色情
fuck小日本	色情
同床	色情
出售账号靠	色情
正清网	色情
后庭	色情
毛售号	色情
枪支弹药	色情
絲襪淫婦	色情
小穴里流	色情
Baichi	色情
mm要我使劲插它的穴	色情
少儿不宜	色情
fuck文化部	色情
欧洲男女激情淫乱穴 mm贴图网	色情
女人被干小穴	色情
强奸29岁处女全过程/淫妹阴毛小穴	色情
套牌	色情
操催情药	色情
中国威胁论	色情
毛拉姆斯菲尔德	色情
毛法轮功	色情
肉棒插进来肉穴	色情
MASTER	色情
小乳頭	色情
第十六次代表	色情
14岁幼女B嫩阴	色情
王力雄	色情
錯B	色情
窩窩客	色情
聚丰	色情
虎骑	色情
鸟GM	色情
天下无双	色情
清華同方	色情
ｇｍ	色情
溫比	色情
迷奸熟妇怎样抚摩女性的私处更刺激	色情
国贼	色情
淫荡贵妇	色情
六月联盟	色情
女死囚	色情
李师傅	色情
色97爱	色情
够酷GOQO	色情
风骚女友浴室放荡	色情
fuck小乳头	色情
大比	色情
推翻	色情
厦门大游行	色情
Tokyo Neko ATN-002 東京猫 Vol。 2 星川はるか	色情
毛外_挂	色情
毛新生网	色情
ｔｉａｎ ｚｈｉ ｌｉａｎ ｙｕ	色情
抽插39岁处女meimei淫叫不断	色情
教你怎样延迟射精37岁以下禁免费淫电影a片	色情
处女阴道特写爽图	色情
毛蒙独	色情
乳此動人	色情
xian jing chuan shuo	色情
色窝窝网之家	色情
賈慶林	色情
新華內情	色情
ucdao	色情
賣號	色情
piss	色情
歡迎G9情色電影院	色情
十八dy毛电影 BTA片 免费激爽电影	色情
在线玩美美免费电影	色情
武林群俠傳	色情
劳改	色情
54xp。com 电影免费	色情
毛联易互动	色情
毛胡紧涛	色情
fuck新疆独立	色情
尹庆民	色情
科技精英遇难	色情
托管理事会	色情
fuck傻屄	色情
新人调教 Red Hot Jam Vol。9 Myuu	色情
fuck文物局	色情
淫汁飛散大亂交	色情
同房	色情
操小姐b	色情
免费秀聊视舞聊天网	色情
伸到老师的小穴里	色情
哭么	色情
明斯克号	色情
fuck万税	色情
赵 紫 阳	色情
日本激情淫色文章	色情
ｈｕｎ ｌｕａｎ ｍａｏ ｘｉａｎ	色情
色慾	色情
婚外恋	色情
免费淫电影网站	色情
免费成人美女	色情
三挫仑	色情
監禁陵辱	色情
教徒	色情
法^輪	色情
伦乱小说大全	色情
揉搓淫骚穴	色情
小比樣	色情
丝诱	色情
免费午夜爽片	色情
张 志 清	色情
天然むすめ 素人~みか	色情
毛阴部	色情
淫奸女电影直接试看	色情
肉棒插入湿湿的肉缝	色情
毛计牌软件	色情
e Idol Vol。19 杏童なつ！【RMVB/698MB】	色情
毛台联	色情
罢饭	色情
ｔｉａｎ ｓｈｉ ｚｈｉ ｌｉａｎ	色情
阴唇	色情
狗狼養的	色情
古龍群俠傳	色情
ｄｕ ｓｈｉ 2046	色情
插meimei小穴	色情
MY	色情
雞歪	色情
姬胜德	色情
ASS李弘旨	色情
公车奸meinv淫奸女电影试看。	色情
┼	色情
少妇扒开阴道图-淫賤少女阴唇特写图免费淫电影a片	色情
gay	色情
多人輪	色情
联总	色情
meimei的屄	色情
伦理淫穴小说	色情
黄祸	色情
每日公告	色情
dtfy	色情
鸡奸	色情
自拍寫真	色情
極品奶妹	色情
柔阴术	色情
超女世界Online	色情
鄧小平	色情
深愛色色	色情
万晓东	色情
少妇扒开阴道图-淫賤少女阴唇特写图	色情
摩力游	色情
蒸汽幻想	色情
裤袜	色情
台湾成人视频聊天	色情
免费黄色淫秽	色情
扒开小穴	色情
退役	色情
幹的你	色情
淫乱工作	色情
納粹	色情
淫水狂喷	色情
fuck新光明	色情
张廷发	色情
小卵泡	色情
日本成人贴图区论坛	色情
falun	色情
少妇房中自淫，和两勇男玩4P，操得直叫爽 操日本淫女穴	色情
hong bao shi	色情
普京	色情
王策	色情
Ｘ到噴屎尿	色情
骚鸡	色情
情色图片	色情
胡志明	色情
┵	色情
毛肉缝	色情
汕頭頻傳擄童割器官	色情
毛干拎娘	色情
性交圖	色情
激情淫贴图网	色情
毛私—服	色情
transvestite	色情
中国移动联电信午夜激情电影秘密通道	色情
fuck湿透的内裤	色情
ｘｉａ ｋｅ ｔｉａｎ ｘｉａ	色情
屌鸠	色情
白癡	色情
狗b新光明	色情
小穴好爽	色情
project	色情
插比	色情
rjwg	色情
…好深啊…操我 插我	色情
干爆	色情
游戏向导	色情
你奶	色情
17大	色情
8 仙	色情
猛戳阴穴	色情
免费成人十八影院	色情
毛屁眼	色情
本站10000多部激情电影全部免费试看三天	色情
整根肉棒被紧箍在幽暗深遽的娇嫩小穴内	色情
pp244淫色导航	色情
抠 插 磨蹭 穴	色情
藏独靠	色情
發倫功	色情
kuai le xi you	色情
傻比	色情
百家性大型黄站妹妹	色情
周鐵農	色情
婷婷激情小说	色情
将则民	色情
cabal	色情
李 瑞 環	色情
张德江	色情
FUCK YOU	色情
wg9996	色情
北韩	色情
騷妻	色情
mimi淫色贴图	色情
连胜德	色情
东突	色情
性戰擂臺	色情
舌头舔弄着小穴的内壁	色情
乱淫自拍图片	色情
懷念十五年前的大學生	色情
亚洲色妹妹	色情
……太舒服了 淫肉穴	色情
毛发轮	色情
少妇房中自淫，和两勇男玩2P，操得直叫爽 操日本淫女穴	色情
春夏自由论坛	色情
壓制	色情
七海りあ	色情
将手指插入她的穴里	色情
成人 激情 性爱 午夜 高潮 情色	色情
淫乱小姨子小说	色情
淫电影 强*十八岁meinv护士看完保证你打飞机	色情
淫电影网站	色情
64動亂	色情
Paki Paki	色情
妈妈的穴	色情
激情性爱电影观看网	色情
搞死	色情
fuck死GM	色情
滛	色情
厕所盗摄	色情
在线免费激情裸聊	色情
88bb成人小电影	色情
淫奸少女论坛	色情
人妖@Lady Sonia-熟女丝袜 12	色情
河利秀失控全裸+深夜成人節目	色情
美女护士被奸	色情
剑网2	色情
媽比	色情
抽插33岁处女meimei淫叫不断	色情
售软件	色情
靠腰	色情
麻醉枪	色情
龟头插入蜜穴	色情
诺亚	色情
问道	色情
做爱视频下载	色情
总统号	色情
方励之	色情
拉姆斯菲爾德	色情
毛奸你	色情
外$$掛	色情
工作人員	色情
激情最新网址	色情
wangce	色情
肉香	色情
林业局	色情
一码中特	色情
操日本淫女	色情
tth2	色情
毛红卫兵	色情
斷电	色情
ｊｉｅ ｔｏｕ ｌａｎ ｑｉｕ	色情
bt成人	色情
邓小平	色情
老B	色情
逼孕套	色情
成人贴图区	色情
少妇房中自淫，和两勇男玩9P，操得直叫爽 操日本淫女穴	色情
六月聯盟	色情
五星红旗	色情
淫水也流湿了我干进她穴内的龟头	色情
mo fa fei qiu	色情
火辣圖片	色情
luan	色情
大肉棒刺入肉穴	色情
粪便	色情
ｇｕａｉ ｓｈｏｕ ｚｏｎｇ ｄｏｎｇ ｙｕａｎ	色情
教你怎样延迟射精18岁以下禁 免费淫 电影a片	色情
淫奸女护士电影在线免费观看点击进入	色情
殺手	色情
傻逼靠	色情
肉棒插入小穴里	色情
淫荡的小穴	色情
淫荡妖艳女医生	色情
联大	色情
滥B	色情
售號	色情
王汉斌	色情
她娘	色情
林心如合成淫照片 林心如淫照片	色情
淫妞	色情
fuck王震	色情
秘裂	色情
弟弟淫奸jiejie	色情
殘廢	色情
帝国主义	色情
遗囑	色情
插后庭	色情
插 干姐姐 好爽	色情
骚妹妹成人导航	色情
fuck孙逸仙	色情
梁光烈	色情
龟头插入少妇	色情
午夜成人影院	色情
岳武	色情
胡緊濤	色情
含着龟头	色情
日本成人	色情
天安门录影带	色情
無碼淫漫	色情
叼你妈	色情
裙下风光	色情
母子交欢	色情
林心如色情贴图 性交贴图	色情
狭义道	色情
chao nv	色情
抗戰	色情
犯踐	色情
小唇被他的嘴巴包裹住	色情
它媽地	色情
kaixuan	色情
幼女淫图	色情
免费淫乱电影下载	色情
150m。com	色情
極品波霸	色情
淫奸电影 淫色猎暴淫电影 射雕淫女传 风骚小龙女 美女淫女图-小龙女淫女俱乐部影 在线淫电影	色情
┥	色情
丁香成人社区	色情
操逼你老母	色情
fuck傻卵	色情
法$綸	色情
總理	色情
jiaochun	色情
瑪雅網	色情
用舌头舔着大小阴唇	色情
吴邦国	色情
国共合作	色情
法$$掄	色情
成人激情影视区在线视频脱衣服	色情
又肥又大的穴	色情
阴茎	色情
*李*洪*志*靠	色情
欧美淫乱meinv论坛 清晰的窥阴图	色情
刘刚	色情
騷卵	色情
郑源	色情
毛英雄纪念碑	色情
迷姦雙胞meimei	色情
your mom your mom	色情
毛小日本	色情
淫女	色情
妹妹小穴	色情
陰茎	色情
ｃｏｎｎａｒｄ	色情
qq视频脱衣秀亚洲少女韩国无码片	色情
如果你未满25周岁请自觉离开。	色情
amateur	色情
钱 达	色情
穴淫贴图女人穴贴图穴淫液贴图	色情
艳照門	色情
wanwang	色情
淫荡少妇露逼自拍	色情
大亂交	色情
大鸡巴插入肉穴	色情
女同志淫乱贴图	色情
╂	色情
圆满	色情
lei ting zhan dui	色情
淫B浪穴	色情
妹妹黄站	色情
肉棒与阴道摩擦	色情
無碼長片	色情
免费淫电影下载地址	色情
赵晓微	色情
毛经济社会理事会	色情
8仙	色情
色情激情电影观看	色情
鄧穎超	色情
懂文华	色情
成人文学	色情
激情淫色游戏	色情
秦 晉	色情
情色 激情 美女 穴	色情
網络公祭	色情
網星艾尼克斯	色情
指导员	色情
挺进小穴	色情
Pink Puncher)Double FACE	色情
外汇局	色情
蕾丝内裤被龟头顶穿	色情
爱图公园	色情
淫荡女医生穴	色情
护士诱惑	色情
nabi	色情
KOKESHI COWGIRL Vol。24 炎的10番勝負2 前編 : 工藤Hatsumi	色情
老瘪三	色情
外-掛	色情
趙紫陽	色情
屁眼	色情
强奸电影网站	色情
dragonheart	色情
admin靠	色情
看完保证你打飞机	色情
367成人网站	色情
丝袜写真	色情
大肉棍… …干的 …好舒服	色情
哀悼	色情
情色成人大全	色情
免费淫电影吴宗宪搞笑语录(20禁看)	色情
免费淫电影吴宗宪搞笑语录(19禁看)	色情
叛黨	色情
九评共产党	色情
誘惑視頻	色情
淫乱金发美女	色情
免费淫奸女Ａ片	色情
混 沌决靠	色情
渡口	色情
大使官	色情
抽插40岁处女meimei淫叫不断	色情
Gm	色情
毛干你妈	色情
在线淫电影 免费淫奸女Ａ片段试看	色情
东西南北论坛	色情
强奸40岁处女全过程/淫妹阴毛小穴	色情
ying xiong wang zuo	色情
互淫	色情
给女人快速达高潮的秘密	色情
毛无界浏览器	色情
强*十八岁meinv护士看完保证你打飞机免费电影	色情
美女做爱激情电影	色情
老女嫩B	色情
风月大陆	色情
game	色情
亚洲穴贴图激情自拍穴	色情
宁王府成人论坛导航	色情
你他马的	色情
新石器	色情
发^伦	色情
japansweet	色情
肉棒插入美女的肉缝	色情
免费成人网站	色情
SM女王	色情
脬	色情
讨伐中宣部	色情
媚药少年	色情
戳那吗逼	色情
討伐	色情
干她妈	色情
UR靠	色情
ｔｉａｎ ｓｈａｎｇ ｂｅｉ	色情
人斩少女3赤裸忍者	色情
和两勇男玩8P	色情
希望online	色情
两岸关系	色情
肉棒深插	色情
毛他爹	色情
meimei的小嫩穴	色情
ＵＲ	色情
温加宝	色情
大型黄站	色情
白液四濺	色情
我第一次舔表姐的阴	色情
弟弟淫奸熟睡姐姐	色情
58jb	色情
淫间道	色情
激情淫电影	色情
毛淫靡	色情
香港激情夜	色情
X媽牛比	色情
毛麦角酸	色情
仙境傳說	色情
淫水愛液	色情
共鏟黨	色情
ｂｉｔｃｈ	色情
game588	色情
性交极品大片 美腿少妇	色情
成人小说	色情
雞雞	色情
叔嫂肉欲	色情
法*功	色情
毛人代会	色情
毛毛贼东	色情
fei chang san guo	色情
台湾成人黄色电影	色情
群交乱舞	色情
歡樂數碼	色情
发@@抡	色情
17game	色情
鸡巴用力深度插入	色情
把精液射进我的小穴里	色情
亚洲激情淫洞	色情
浪女淫水	色情
和阿姨乱伦	色情
32283	色情
农业部	色情
日他	色情
色貓	色情
MM嫩穴	色情
战牌靠	色情
大 中 国 论 坛	色情
顺着大鸡巴湿淋淋的流下	色情
屎妳娘	色情
粉饰太平	色情
髙潮	色情
令人喷血的春宫108姿势(组图)18岁禁看	色情
da qing di guo	色情
殺人犯	色情
urban-rivals	色情
星空幻想	色情
毛反政府	色情
精液喷涌而出	色情
毛江猪媳	色情
睾	色情
江主席	色情
陳水扁	色情
whore	色情
歡迎G11情色電影院	色情
天之炼狱	色情
幹妳娘	色情
又大又嫩的穴	色情
喬石	色情
ｂｉａｏｚｉ	色情
免费淫奸女Ａ片段试看 20岁女大学生被强	色情
少女嫩穴被插出血	色情
美少女FUCK限界大挑戦	色情
毛私-服	色情
血B	色情
搞B	色情
ling you ji	色情
無需入會	色情
馬万祺	色情
爆草	色情
诛仙	色情
fuck售号	色情
操插Gm	色情
爆乳娘	色情
红十字会	色情
操操你妈屄	色情
天安門一代	色情
法~~輪	色情
新疆國	色情
a$$hole	色情
舐她的小穴	色情
半夜我把龟头插进meimei的深处	色情
日本MM色比图吧	色情
gm	色情
法沦功	色情
發侖	色情
放屁	色情
168www	色情
妹妹的小淫穴	色情
肉棒狠狠插嫩穴	色情
余秋里	色情
meinv视频图情色贴图区成人性光牒	色情
性免費電影	色情
毛青天白日	色情
CUP爆乳家庭教师	色情
肉棒直插花心	色情
肉棒狂插女人小嫩穴	色情
熟女玩3P内射来满足欲望	色情
干的好爽……要爽死我了	色情
法@輪	色情
阴唇湿润小妹舔乳	色情
小穴……好爽 菊穴	色情
毛澤東	色情
轮盘机	色情
保證很像學生妹	色情
高级逼	色情
联易互动	色情
百家性大型黄站视频	色情
神之领域	色情
毛唐家璇	色情
se淫乱jiejie小说	色情
平成女忍者 奥义中出し陵辱	色情
酥穴	色情
楊思敏	色情
斐得勒	色情
g片	色情
新疆分裂	色情
套弄鸡巴	色情
信仰	色情
神出鬼没!3个丁字裤辣妹到处袭击肉棒(中文字幕	色情
淫电影//现场强奸20岁处女扒开小穴清晰做爱阴道裸体图	色情
美腿美穴大屌	色情
張 鋼	色情
網域	色情
12次下跪	色情
美乳斗艳	色情
亚洲激情 贴图区	色情
TokyoHot之极品妹妹	色情
石首	色情
色网阴道特写强奸27岁处女全过程	色情
啊……快插啊……小屄要美死了……	色情
用舌头舔着他的马 眼	色情
18岁淫乱	色情
成人电影	色情
艳乳	色情
fuck外汇局	色情
外_挂	色情
操肏	色情
免费激情影院	色情
淫色	色情
管裏員	色情
班禅	色情
强奸24岁处女全过程/淫妹阴毛小穴	色情
激情导航	色情
ｍｏ ｆａ ｑｉ ｂｉｎｇ	色情
针扎	色情
┅┅手握住我的大肉棒	色情
六四风波	色情
神雕外传之郭襄	色情
8？9靠	色情
十七大	色情
独占Princess Collection 若叶	色情
fuck新闻出版署	色情
黑马@meinv全身神秘黑让你爽到眼框黑	色情
盘古软件	色情
吹簫	色情
兩個中國	色情
22park	色情
私服	色情
金瓶梅2	色情
陈总统	色情
大鸡吧插人阴户	色情
meinv主持26小时全天激情热舞	色情
回民暴動	色情
freechina	色情
天然むすめ~08-15 素人むすめたち	色情
乱世三国	色情
淫水淋湿的阴毛	色情
恥辱醫護下载	色情
足球经理	色情
葫芦案	色情
吊	色情
wow711	色情
陈晓宁	色情
张万年	色情
毛共青团员	色情
昏迷	色情
妈祖	色情
成人社区	色情
光宇華夏	色情
毛嫩b	色情
ｎａｂｉ	色情
胡景濤	色情
顶到妈妈娇嫩的花心	色情
法轮工	色情
六四真相	色情
邓力群	色情
fuck性交	色情
插你丫的	色情
孙家正	色情
乳房	色情
性福源亚洲激情	色情
荡妇	色情
反共	色情
整个龟头插入小穴	色情
让你操	色情
大海戰II	色情
嫩鲍	色情
穴口挤出淫水	色情
圣火	色情
我和姐姐	色情
粗硬 大 龟头 狂插	色情
mforest	色情
……插的……好舒服	色情
妹妞露穴	色情
迅雷下载免费黄色淫乱电影 免费淫奸女Ａ片段	色情
外•挂	色情
cjsh	色情
骚穴怒放	色情
滚那吗老比	色情
密穴	色情
抽插19岁处女妹妹淫叫不断	色情
可哥精	色情
MUGEN EX Vol。3 魅惑美少女 : 小日向葵 有码女优首度无码隆重登场	色情
TMD	色情
亚洲激情淫影院	色情
处女阴道库	色情
淫奸jiejie电影	色情
妈妈屄好痒呀	色情
fuck王兆国	色情
免费电影吸精痴女	色情
黄色淫乱电影	色情
群奸轮射	色情
非常不错的人妻轮奸	色情
手记注册日韩5005部激情电影	色情
zhuanfalu	色情
MM的小穴	色情
中华人民共和國	色情
奧運	色情
插深些	色情
湿透的内裤	色情
ya dian na	色情
一夜性网	色情
日本大型黄色美女做爱	色情
熱血英豪	色情
露b	色情
本站所有电影完全免费无需手机注册	色情
漂亮女站着撒尿躺下被操	色情
干八个meinv的小穴	色情
淫电影网	色情
┴	色情
妈的	色情
吗啡片	色情
狗成	色情
大*FA弟*子	色情
58xp。com 电影免费	色情
ｈｕａｎｇ ｙｉ ｑｕｎ ｘｉａ ｚｈｕａｎ	色情
西游伏魔录	色情
盐酸二氫埃托啡	色情
吸精痴女護士	色情
中国孤儿院	色情
免费黄色淫电影一社会男子在宾馆里强奸一	色情
天安门事件	色情
毛王昊	色情
殺你全家	色情
激情黄色在线	色情
法溣功	色情
系统管理员	色情
毛王震	色情
ｋｕａｉ ｌｅ ｘｉ ｙｏｕ	色情
liu xing xue yuan	色情
欧美激情淫影院	色情
賽博先鋒	色情
性生活	色情
jiba	色情
毛发伦功	色情
中国问题论坛	色情
我和她	色情
蘚鮑	色情
公媳乱	色情
激情電影	色情
毛毛厕洞	色情
贱货	色情
联合国大会	色情
窃听器	色情
日本淫荡电影	色情
日本激情图库脱衣裸体做爱	色情
大B私服	色情
张宏堡	色情
叫雞	色情
流星蝴蝶劍	色情
淫穴嫩穴	色情
手记注册日韩5027部激情电影	色情
贱B	色情
精选明星扒b图	色情
卐	色情
發@@綸	色情
JPEEN	色情
外交与方略	色情
台湾成人23贴图	色情
毛新闻办	色情
iuiuu	色情
共军	色情
三去车仑	色情
法沦	色情
遊行	色情
淫奸护士穴论坛	色情
爱妻淫穴	色情
求你插插我吧好痒	色情
張 偉 國	色情
Test	色情
雞	色情
做愛電影	色情
亚洲淫色贴图论坛	色情
羞恥母	色情
抽插48岁处女妹妹淫叫不断	色情
中文情色网站 免费母子乱伦	色情
燕玲論壇	色情
ｎｅｔ	色情
Tora Tora Gold Vol。15 香山圣	色情
毛监察部	色情
金日成	色情
姚依林	色情
晚年周恩来	色情
激情日本电影_成人情色电影_成人小电影	色情
操淫荡 空姐	色情
抽插婷婷	色情
超强护士团	色情
东亚共荣	色情
光之国度	色情
淫水橫流	色情
被噁心男搞到高潮不停的立花里子	色情
fantasyjourney	色情
援交	色情
孙中山	色情
强奸美女狂插处女阴道	色情
姚文元	色情
愛色cc	色情
3P炮图	色情
压迫	色情
9ｙｏｕ	色情
亲哥哥……妹妹的小穴……舒服死了……	色情
夫妻自拍	色情
经济社会理事会	色情
小騷貨	色情
chinesenewsnet	色情
用劲吸吮咬舐着湿润的穴肉	色情
台湾成人20贴图	色情
www。ccwcc。cn	色情
聚友网络	色情
亚洲成人电影	色情
婬	色情
20dy淫色贴图	色情
朱溶剂	色情
打到中国	色情
抽插54岁处女妹妹淫叫不断	色情
大波	色情
田纪云	色情
猪容基	色情
狂插meinv老师	色情
日本激情淫	色情
新大陸	色情
在线免费淫电影	色情
俄罗斯激情淫色贴图	色情
手机注册激情网站	色情
ｘｉｎｇ ｚｕａｎ ｗｕ ｙｕ	色情
风骚欲女爽爽网	色情
不玩了	色情
迷人阴部护士妹妹也疯狂	色情
屌妳	色情
世界日報	色情
药物奸淫女高校生A片	色情
20岁处女偷拍/免费A。B片	色情
森田めぐみ 凌辱饲育	色情
阿姨的阴道好大啊	色情
Maki	色情
meinv视频短片	色情
毛伊斯兰	色情
中华人民实话实说	色情
母亲	色情
游戏宫理员	色情
骚嫩的蜜穴紧紧地裹着大鸡巴	色情
中宣部是中國的愛滋病	色情
邵家健	色情
邪教	色情
藏青會	色情
淫少妇	色情
黑客	色情
毛美国	色情
碩大龜頭緊緊頂著她的阴道	色情
┋	色情
亚洲成人网 鹿城最新娱乐网	色情
张钢	色情
亚洲激情淫色电影	色情
嫩b	色情
@sshole靠	色情
贾庆林	色情
淫水从穴门流出	色情
江Core	色情
乱伦之淫穴	色情
中央電視臺	色情
喷尿	色情
18岁处女床上开苞	色情
趙 紫 陽	色情
porn	色情
色区	色情
酒店援交	色情
洪 传	色情
亚洲午夜激情那个电影中心	色情
89年的斗争	色情
连邦	色情
龟头插入阴唇	色情
爆乳家庭教师	色情
放荡少妇	色情
sh!t	色情
示威	色情
阴茎在子宫口游荡	色情
綠色數碼	色情
mm乱淫自拍图片	色情
20岁女大学生被强#(组图)全过程免费淫 电影	色情
玉杵	色情
桃园蜜洞	色情
淫乱护士	色情
娘餓比	色情
淫语连连	色情
本站10021多部激情电影全部免费试看	色情
去你妈的	色情
都市2046	色情
王子傑	色情
毛回族人吃猪肉	色情
屄屄	色情
無碼無套	色情
TNND	色情
流出大量淫水	色情
鸦片液	色情
汉奸	色情
干您	色情
七五事件	色情
手淫~少妇自慰喷淫水	色情
台湾成人电影	色情
redmoon	色情
龙腾工作室	色情
弟弟mojiejie胸部小说	色情
九评	色情
毛双峰微颤	色情
ｓｈｉｔ	色情
倭寇	色情
大胆出位	色情
宾馆女郎	色情
rfa	色情
fuck五星红旗	色情
农民伯伯乡下妹	色情
品色堂	色情
都市情爱乱伦淫妻古典武侠制服明星性爱宝典24式教材	色情
changeu	色情
貞操	色情
谢长廷	色情
法~~纶	色情
满洲国	色情
fuck舔西	色情
ｂ样	色情
svs	色情
大东亚	色情
成人导航网	色情
巡查	色情
狂插秘书穴	色情
日内瓦金融	色情
军事委员会	色情
吳邦國	色情
マーメイドになった「恋から」ギャル。岡島優里（全编）	色情
阿雅娃娃	色情
meinv极品嫩穴	色情
骚妹阴道	色情
成人激情爽电影	色情
毛买财富	色情
毛外挂	色情
日穿	色情
威而柔	色情
天天干貼圖	色情
賽妳阿母	色情
6？4靠	色情
刘晓竹	色情
愛的奉献	色情
『第一爽图区』	色情
毛多维周刊	色情
完美時空	色情
亚情	色情
假钞	色情
超恶い状态10人の俗人たち	色情
星光伴我淫	色情
官方	色情
妈妈嫩穴…痒	色情
meimei的阴蒂	色情
狂插日韩骚逼打飞机必看	色情
李总统	色情
免费淫虫在线看电影	色情
毛日你妈	色情
亚洲激情片	色情
毛江八点	色情
和meimei玩插穴	色情
抽插19岁处女meimei淫叫不断	色情
和两勇男玩37P	色情
帳號	色情
教你怎样延迟射精21岁以下禁免费淫电影a片	色情
插你全家	色情
免费淫爆影片	色情
淫奸秘书电影	色情
网络创世纪	色情
fuck天皇陛下	色情
毛国民党	色情
小嫩逼	色情
火麻	色情
白浆四溅	色情
国家民委	色情
X妈牛比	色情
(現映社)オバサマ5人 潮吹き絶叫雨あられ!	色情
免费淫奸女Ａ片段试看 教你怎样延迟射精18岁以下禁免费淫电影a片	色情
追查國際	色情
检察院	色情
激情淫贴图	色情
手记注册日韩5001部激情电影	色情
手机激情淫色网址	色情
东条	色情
小穴里抽插	色情
人妻自拍	色情
烂比	色情
肉棒插入小姨的肉縫	色情
中天萬方	色情
鸡巴受不了了┅┅要泄	色情
煞筆	色情
毛官逼民反	色情
操草拟妈	色情
乱伦小荡妇	色情
劲乐	色情
插的妹妹好爽啊	色情
毛肉棍子	色情
zhenshanren	色情
美女含双棍玩内射	色情
丝路传说	色情
刀剑•英雄	色情
直操她嘴射精	色情
李至伦	色情
嫂嫂我要	色情
偷拍	色情
淫女小电影	色情
呆卵	色情
法$$轮	色情
G m	色情
狂插 鸡巴狂插	色情
ｂａｏ皮	色情
回民吃豬肉	色情
超级色情网站 乱伦色情小说 香港娱乐网黄站 性bt论坛	色情
日本帝国	色情
allbisexual。com	色情
to173	色情
干她	色情
bt淫色贴图	色情
T。M。D靠	色情
ｔｉ ｔｉ ｑｉｕ	色情
毛死gm	色情
郁慕明	色情
digimagics	色情
herogame	色情
鸡巴狠狠插入娇嫩夹紧的阴道中	色情
成人小说 SM 做爱	色情
梦幻情人射了10次的强片	色情
三陪女	色情
petrealm	色情
操医生小穴	色情
天纵	色情
免费淫电影吴宗宪搞笑语录(18禁看)	色情
夜色城	色情
英雄王座	色情
韓啓德	色情
法^抡	色情
骚B贱	色情
大鸡巴好趐┅┅趐┅┅快┅┅别揉了	色情
李岚清	色情
天浴	色情
AV女优 激情小电影 熟女俱乐部	色情
ｌｕａｎ ｗｕ ｔｉａｎ ｘｉａ	色情
毛牛比	色情
弟弟的肉棒好大啊	色情
法仑工	色情
古龙群侠传	色情
雜種	色情
山口組	色情
大鸡巴插进了的小穴	色情
抽插38岁处女meimei淫叫不断	色情
guild wars	色情
处女性开苞	色情
保证你打飞机免费电影网站	色情
神经病	色情
姐姐的阴户	色情
阿姨的穴┅好爽	色情
钱其琛	色情
大便	色情
阴小撕大	色情
女幹三虧	色情
艳照	色情
爽mm	色情
怎样免费看淫电影	色情
ｌａｑｉａ	色情
fuck王昊	色情
深喉 Deepthroat This 8	色情
enculer	色情
黄色漫画	色情
那嗎老比	色情
雞叭	色情
强奸22岁处女全过程/*妹阴毛小穴	色情
溫B	色情
圆滿	色情
生徒胸触	色情
激情meimei聊天室	色情
傻×	色情
色网阴道特写强奸34岁处女全过程	色情
tibet	色情
几叭	色情
日本娱乐性免费电影在线	色情
腳交	色情
王勝俊	色情
鸡吧刺入她肛门	色情
火棒	色情
瘸腿幫	色情
バコバコ风俗 W指名 遥めぐみ×美优千奈 A	色情
法*淪	色情
在骚穴里抽插著阳具	色情
jiejie被轮奸	色情
玩逼	色情
午夜激情	色情
ｂｉ样	色情
色诱	色情
抽动肉	色情
女幹	色情
血比	色情
產黨	色情
和两勇男玩48P	色情
法*纶	色情
meimei的小穴好紧啊	色情
阴道好肥啊	色情
儿子添着妈妈肥大湿润阴唇	色情
烂货	色情
無界流覽	色情
台湾民国	色情
苏东解体	色情
钓鱼台	色情
禽兽	色情
大揭露	色情
美女视频图情色贴图区成人性光牒	色情
操淫荡meimei穴	色情
淫民激情文学图库专题	色情
老骚货	色情
妈浪女骚	色情
免费淫色情电影 20岁女大学生被强#(组图)全过程	色情
骚水	色情
一对熟女间的性虐游戏	色情
六四运动	色情
处女淫荡色情网址大全	色情
ｔｘｓａｎｇｕｏ	色情
淫荡少妇被轮奸	色情
xyd	色情
阿姨的阴户好紧	色情
毛美国佬	色情
勁爆	色情
娘B	色情
鸟gm	色情
東京熱最受歡迎長腿meinv~藤澤安奈~腿長人又漂亮	色情
只允许法规年龄的人注册	色情
光通	色情
毛两腿之间	色情
hui huang	色情
肉沟	色情
鸦片渣	色情
天图	色情
逼奸	色情
裸体少妇	色情
强暴	色情
欢乐城	色情
阴屄	色情
肉棒在阴道内喷射	色情
╆	色情
作弊器	色情
夫妻亂交	色情
狂插meimei小穴	色情
台湾成人21贴图	色情
pp242淫色导航	色情
免费淫电影吴宗宪搞笑语录(23禁看)	色情
ｘｚｈｏｎｌｉｎｅ	色情
色男淫女	色情
插 10p	色情
发~~仑	色情
毛王太华	色情
meinv网站脱衣meinv百分百作爱	色情
啊……我的小屄……给你……肏得好……舒服……	色情
花和尚成人论坛 成娱情色导航	色情
chengmingmag	色情
淫民俱乐部和美女发春激情3级片试看	色情
操姐姐的穴	色情
黄色免费淫乱电影 淫女色情图片	色情
姐姐和我乱伦理小说	色情
WEB牌戰靠	色情
联梦	色情
瘟比	色情
外陰	色情
走向圓满	色情
成熟性感大美女	色情
射	色情
┝	色情
貝肉	色情
肛門噴水	色情
婷婷激情网	色情
被10个猛男轮奸草得血直流	色情
鳳舞天驕	色情
那吗老比	色情
淫乱激情电影网站	色情
少妇白洁的淫乱生活	色情
bbscity	色情
肏妹妹屄	色情
毛我干	色情
大鸡巴干meimei	色情
藤仁	色情
集會	色情
┣	色情
性保姆被雇主掀翻在高潮	色情
穴门美女图库	色情
ｍｏｘｉａｎｇ	色情
发论功	色情
杀你全家	色情
口肯	色情
毛我日你	色情
松花江污染	色情
夜话紫禁城	色情
骑他	色情
免费强奸淫电影	色情
亚洲/无码	色情
fv(	色情
騒	色情
全球第一淫图城	色情
教你如何鉴别处男处女的方法(组图)18岁禁看免费淫电影a片	色情
法~倫	色情
郑义	色情
嫖客	色情
走光	色情
周容重	色情
MM屄	色情
毛江贼民	色情
Homosexual	色情
光线	色情
da hang hai	色情
和两勇男玩51P	色情
南大自由论坛	色情
小雞巴	色情
鸭店	色情
毛膏药旗	色情
梦~ 总辑篇-GONZO Vol。 4 Rio	色情
瞳-饮精地狱!监禁无限中出	色情
淫穴电影网	色情
圣淫乱学院	色情
斯大林	色情
風騷欲女	色情
骚妇激情	色情
五星紅旗	色情
月经	色情
露屄	色情
美媚穴贴图	色情
adult	色情
毛江主席	色情
無修正	色情
free style	色情
消息公告	色情
抽插大淫穴	色情
吞精骚妹	色情
弟弟的肉棒又粗又大	色情
妹妹騷圖	色情
受伤	色情
台聯	色情
偷拍掰开阴唇做爱	色情
不倫繼母的性猥褻	色情
世纪天成	色情
美护士是男人操屄的目标	色情
pp点点激情播放	色情
OL美女街上遥控震动A	色情
联易	色情
母女双飞	色情
长途汽车上的淫乱乘客	色情
丰唇艳姬	色情
美乳美穴	色情
鹿城百家性大型黄站	色情
LineageⅡ	色情
妹妹嫩穴被狂插	色情
万税	色情
色情网址网上做爱	色情
耶和华	色情
毛俞正声	色情
淫店	色情
销售	色情
Tokyo Hot n0188 田中爱	色情
everstar	色情
愛的奉獻	色情
军妓	色情
出售此号靠	色情
台湾成人黄色网站	色情
插你祖宗	色情
生徒胸觸	色情
在线激情电影 - 会员注册	色情
香港激情论坛	色情
ｚｈｅｎ ｋｏｎｇ ｑｕｅ ｗａｎｇ	色情
群奸輪射	色情
欣赏特级毛片pp 点点毛片 美女毛片 大陆毛片	色情
抽插48岁处女meimei淫叫不断	色情
干丰满少妇	色情
巨屌	色情
A片大放送	色情
成人A片	色情
亚洲淫色俱乐部免费淫	色情
三个代婊	色情
法~~论	色情
毛强效失意药	色情
pp点点通色穴激情片	色情
成人导航	色情
日本激情淫影院	色情
强奸大奶嫩逼美女	色情
張 宏 堡	色情
肉缝	色情
比的	色情
消息	色情
嫩穴狂插还流水	色情
純情尤物由美（中文字幕）	色情
大血比	色情
中南海	色情
午夜影院	色情
大煙	色情
辣妹狼图~肏穴图	色情
現貨	色情
免费淫乱卡通动画片	色情
阳具插入小穴中	色情
bjzc	色情
军转	色情
马的	色情
则民	色情
屠城	色情
处女开苞	色情
亚洲成人俱乐部	色情
幹死客服	色情
免费成人影片	色情
鄧 笑 貧	色情
阴莖	色情
金发表姨花蕊，少女的狭窄洞口	色情
美女网站脱衣美女百分百作爱	色情
和两勇男玩15P	色情
台湾政论区	色情
鹿城黄站bt	色情
哥哥淫奸meimei穴	色情
日本淫色贴图区	色情
解放軍306醫院	色情
jx	色情
免费注册 试看50部	色情
Biao子	色情
外@掛	色情
幾巴	色情
fuck受虐狂	色情
苯甲基芽子堿	色情
姘	色情
激情　电影	色情
娇嫩的小阴核	色情
da hua zhan guo	色情
臭鸡巴	色情
賣國求榮	色情
灵游记	色情
麥角酸二乙基醯胺	色情
无码炮图	色情
绕过封锁	色情
鮑彤	色情
台湾党	色情
毛乳交	色情
鹿城黄站图	色情
老毛	色情
厕所盗摄meinv性感	色情
比水	色情
情色 美女 -公安机关 -记者 -犯罪嫌疑人	色情
暴淫	色情
asgard	色情
赵南	色情
老騷貨	色情
武林外转	色情
毛傻子	色情
毛卖B	色情
白虎嫩B	色情
发抡功	色情
中奖	色情
干Gm	色情
抽插47岁处女妹妹淫叫不断	色情
毛广电局	色情
蔣中正	色情
毛密宗	色情
美女走光	色情
淫荡少妇穴少妇嫩穴 美女的嫩穴	色情
姐姐的穴好大啊	色情
中国人民解放军	色情
台湾18成人网站	色情
免费淫色情电影 淫电影//少女被强奸到高潮时偷拍小A片	色情
全免激情聊天室	色情
f a 輪	色情
强奸45岁处女全过程/淫妹阴毛小穴	色情
渣波波	色情
草擬媽	色情
毛透视眼镜	色情
奸淫护士	色情
去氧麻黄碱或安非他命	色情
内衣模特露点走光	色情
妹妹的屄好紧啊	色情
Marc Dorcel)Jesse & Jenna expertes du vice	色情
駛你母	色情
SM舔穴	色情
阴茎被她紧紧地夹住感到肉洞急促地收缩	色情
幼女玩性	色情
天安们母亲运动	色情
淫meimei电影论坛	色情
獸欲	色情
虎门靠	色情
毛推油	色情
信息产业部	色情
龟头在阴道里抽插	色情
heatproject	色情
和熟睡的meimei做爱教你一手	色情
美国	色情
乳头	色情
卡通meinv淫乱图	色情
他母親	色情
在线看淫色电影	色情
劫机	色情
大鸡巴好粗…	色情
毛肛	色情
驶你老母	色情
幹拎娘	色情
網 特	色情
操美女穴	色情
fuck驶你公	色情
光明日报	色情
制服誘惑	色情
操少妇嫩穴	色情
淫情	色情
阿兵哥艳遇录	色情
六四點擊	色情
淫蕩	色情
┭	色情
incest	色情
毛三级片	色情
激情电影免费下载裸体美女乳房图	色情
退黨	色情
換妻	色情
素人著エロ俱樂部 こももちゃん	色情
66xp。com 电影免费	色情
测試員	色情
ｍａｂｉｎｏｇｉ	色情
一党独裁	色情
吴桂贤	色情
。gm	色情
龟头被舔得又麻又痒	色情
虐待	色情
黃孟複	色情
賤	色情
和阿姨做爱	色情
清晰内射	色情
JHSZ	色情
高自联	色情
騷B	色情
毛狗养	色情
sega	色情
快活林导航	色情
动乱	色情
淫浆	色情
豔照門	色情
蝴蝶逼	色情
写真	色情
南蠻子	色情
Red Hot Jam Vol。8 让你用子宫感觉 藤崎夕凪	色情
女优	色情
又大又硬的肉棒	色情
肉棒插得我好爽	色情
易志熹	色情
完美國際	色情
完蛋操	色情
毛台独	色情
發~~綸	色情
Ttmd	色情
激情美穴	色情
赛你娘	色情
抽插21岁处女meimei淫叫不断	色情
这年头就这样	色情
基地組織	色情
免费成人电影	色情
肉棒好粗啊	色情
疆独	色情
中国恐怖组织	色情
法*轮*功	色情
豐唇豔姬	色情
fuck威而钢	色情
荡妹	色情
死刑枪毙	色情
操淫荡少妇 操淫荡meimei	色情
好紧的屄啊	色情
法@綸	色情
又黑又粗长的鸡巴	色情
觀世音	色情
毛驶你公	色情
偷窥图片	色情
法抡功	色情
自慰女學生廁所偷拍in Toilet 1	色情
輪子功	色情
六四之后	色情
激情妹妹聊天室	色情
帕巴拉？格列朗傑	色情
xia ke tian xia	色情
妹妹的嫩阴户	色情
小鱼儿与花无缺	色情
风艳阁	色情
法**纶	色情
震级	色情
歡歡娛樂時空	色情
奥运	色情
淫乱护士电影	色情
破處	色情
搞他	色情
册那	色情
jhsz	色情
qiangjian	色情
抽插55岁处女meimei淫叫不断	色情
台灣倫亂網	色情
抗震	色情
鸟Gm	色情
风骚侍女	色情
亚洲激情淫少妇贴图	色情
毛我日	色情
诱色uu	色情
夫妻作爱电影	色情
灾區	色情
宋楚瑜	色情
搖頭丸	色情
精液射进妈妈穴里面	色情
香港激情图源成人色情论坛脱衣meinv做爱	色情
╇	色情
六四運動	色情
溫傢寳	色情
快樂西遊	色情
淫荡的奸淫	色情
毛胡紧掏	色情
臺幣	色情
外？挂	色情
发纶	色情
拉案	色情
江八点	色情
segame	色情
mm激情穴贴图	色情
毛税务总局	色情
東方資通	色情
毛鸦片渣	色情
强奸少妇	色情
自拍美穴	色情
少妇自淫	色情
色迷城	色情
歡迎G12情色電影院	色情
地震捐款	色情
毛淫语连连	色情
我和少妇做爱	色情
玉蒲园淫书淫图射	色情
赛维创世	色情
肉棒在小穴深初来回抽动	色情
免费淫色情电影 教你怎样延迟射精18岁以下禁	色情
星际online	色情
aika	色情
淫荡美女医生	色情
狂插美女护士小说	色情
豬頭	色情
成人激情性爱电影	色情
最新一本道~超级名模系列第13弹 : 真乃瞳	色情
注册激情电影(切记只允许法规年龄的人注册)注册快感吧！！	色情
黄　菊	色情
毛国家民委	色情
a片	色情
張 萬 年	色情
濕穴	色情
淫聲浪語	色情
小骚比	色情
連戰	色情
免费淫奸女Ａ片段试看 强*十八岁美女护士看完保证你打飞机	色情
包二奶	色情
你娘	色情
好大的阴户	色情
MUGEN EX Vol。4 吉川萌	色情
淫圖	色情
欧美激情成人电影	色情
鎷	色情
强奸处女学妹，摄像机拍下强奸阿姨。	色情
迷人小穴好紧好湿	色情
發^^論	色情
它妈的	色情
色弟弟	色情
毛主席	色情
喪服妻欲望下载	色情
Pajawa Pajawa	色情
淫液顺着肉洞流下	色情
MUGEN EX Vol。7 濱崎(MX-07)	色情
惹火身材	色情
胡嘉	色情
淫奸阿姨穴	色情
勃大精深	色情
少女 被 插	色情
fuck十年动乱	色情
奶挺臀翹	色情
╅	色情
插得好爽啊	色情
淫妻交換	色情
壓迫	色情
鸡吧	色情
韩国激情淫色网站	色情
无码片	色情
管理	色情
毛吗啡碱	色情
教你怎样延迟射精40岁以下禁免费淫电影a片	色情
做爱淫乱小说	色情
干尼	色情
疯狂的抽插	色情
三级电影淫电影艳情电影	色情
艳尻 北原多香子	色情
基督基督教	色情
海之樂章	色情
ｍｆｏｒｅｓｔ	色情
唐人电视台	色情
免费A片日本淫电影	色情
ｓａｏｂｉ	色情
av电影 色情导航	色情
布雷爾	色情
妹妹的小嫩穴	色情
法@論	色情
张潮阳	色情
抽插47岁处女meimei淫叫不断	色情
反黨	色情
和親姐姐作愛	色情
易當	色情
hanbit	色情
钦 本 立	色情
姐姐的阴道好嫩啊	色情
江core	色情
星际家园	色情
免费性爱电影网	色情
又嫩又紧的穴	色情
我和网吧老板娘	色情
抽插52岁处女妹妹淫叫不断	色情
泳衣+丝袜~让你销魂舒畅	色情
二B   帝国	色情
萨斯	色情
K姐	色情
湿了还说不要	色情
张开双腿　菊花穴	色情
meinv发春激情在线电影	色情
毛狗卵	色情
插小穴	色情
Sex	色情
臺灣是主權國家	色情
法仑攻	色情
操妳媽	色情
淫女教师小说	色情
捅进她的阴道	色情
吳 宏 達	色情
ｌｉｕ ｘｉｎｇ ｈｕ ｄｉｅ ｊｉａｎ	色情
J-spot PA-39	色情
色窩窩	色情
赤龙剑心	色情
原味絲襪	色情
發~~倫	色情
你是雞	色情
无关键词(导航搜索)	色情
嫩奶	色情
慶 紅	色情
美腿丝足	色情
操穴	色情
冈村秀树	色情
操测绘局	色情
BT激情无码	色情
臺灣總統	色情
毛你爸	色情
阴缔	色情
fuck售软件	色情
她的阴道真紧	色情
NMD	色情
菊地麗子	色情
李建國	色情
和妹妹肏穴	色情
89风波	色情
server	色情
处女的肉穴给他的肉棒一插到底	色情
INSERT	色情
鸡吧菊花穴	色情
淫穴贴吧	色情
43lian色站大全	色情
激情成人乐园	色情
强奸36岁处女全过程/淫妹阴毛小穴	色情
淫魔	色情
ｔ2ｄｋ	色情
淫奸女同事穴	色情
日本淫蕩孕婦	色情
又大又粗的肉棒	色情
操烂	色情
自由之門	色情
肛	色情
如果你未满33周岁请自觉离开。	色情
日本淫荡女孩	色情
大鸡吧插进阴道	色情
Alod	色情
法*輪*功	色情
和婶婶做爱	色情
色情工厂	色情
百家性大型色站	色情
365 sex	色情
毛民政部	色情
小泉純一郎	色情
成人黄色电影	色情
毛狗操	色情
八老	色情
手伸到下体抚摸嫩穴	色情
仙侶奇緣	色情
fuck手机复制	色情
赌博	色情
肉棍干骚妇	色情
fuck托管理事会	色情
妹妹被操的淫水直流	色情
法^^侖	色情
毛乡巴佬	色情
东条英机	色情
ｏｎｌｉｎｅｗｏｒｍｓ	色情
捅我	色情
色中色网址大全	色情
淫奸美女穴	色情
毛售软件	色情
淫女小穴	色情
幹死你	色情
boke	色情
水去車仑	色情
戴 相 龍	色情
朱毛	色情
本站10014多部激情电影全部免费试看三天	色情
FLG 妈批	色情
強姦處女	色情
create	色情
onlineworms	色情
溫家寶	色情
白虎阴穴	色情
姐姐被插的好爽	色情
口合	色情
１８摸	色情
贱b	色情
Bastard	色情
龟头缓慢地从我的阴道中戳入拉出	色情
藤任	色情
歡樂時代	色情
厕所盗摄护士jiejie性感美腿图 肉丝美腿艳情淫欲	色情
愛女人	色情
遗嘱	色情
懒8	色情
淫奸阿姨电影	色情
情色谷	色情
PORN	色情
做鴨	色情
子宫	色情
嫵媚挑逗	色情
Tokyo Hot n0252 原田友美 高飞车美人教师精液炸沉	色情
曰gm	色情
红楼 绮梦	色情
遇難	色情
残疾	色情
淫电影//少女被强奸到高潮时偷拍小A片	色情
你妈	色情
江湖使者	色情
ai滋	色情
street of EROS 07	色情
爆操	色情
ｍｅｉ ｌｉ ｓｈｉ ｊｉｅ	色情
弓虽	色情
阴部特写	色情
癟三	色情
本。拉登	色情
ｓａｎｇｕｏｈｘ	色情
滑湿小屄洞	色情
张伟国	色情
beijingspring	色情
王乐泉	色情
集體淫	色情
又紧又嫩的屄儿	色情
儿子添着妈妈大的阴唇	色情
海盜時代	色情
…好棒啊……好舒服	色情
王秀丽	色情
强奸21岁处女全过程/淫妹阴毛小穴	色情
都市乱伦	色情
卡通美女淫色贴图	色情
干一干	色情
Tmd	色情
两性淫乱小说阅读	色情
反政府	色情
o2jam	色情
星战前夜	色情
免费在线黄色小电影	色情
菜B	色情
濫逼	色情
共产	色情
毛国家主席	色情
掄功	色情
毛罗　干	色情
和两勇男玩20P	色情
操mm穴交	色情
ｓｅｇａｍｅ	色情
性虎	色情
網愛	色情
美国成人激情网站	色情
东升	色情
網絡公祭	色情
日你媽	色情
流星蝴蝶剑	色情
宝德	色情
让我操高潮淫水一直流溅	色情
鸡巴对准淫穴	色情
草你媽	色情
RMB	色情
三级片看美国女人的性交	色情
四川獨立	色情
306醫院	色情
一贯道	色情
劳拉	色情
海关总署	色情
淫奸熟睡小姨子	色情
臺灣島國	色情
法$抡	色情
坐脸	色情
假陽具插穴	色情
绝品meinvが恍惚颜の绝顶快感	色情
台湾淫色网	色情
复辟	色情
胡锦涛靠	色情
疯狂的抽插起来	色情
JB靠	色情
美神ルナ Runa Mikami	色情
滚	色情
学生妹同男友夜晚做爱并轮插	色情
肉棒挤入蜜穴	色情
湿了还说要	色情
肉棒嫩逼	色情
传销	色情
安纳咖	色情
乳此豐滿	色情
meimei的大阴唇好嫩啊	色情
全免费淫色电影	色情
淫叫	色情
ハイパー×潮吹きハイパ 麻美ゆま	色情
淫B	色情
發^倫	色情
本站10016多部激情电影全部免费试看	色情
激情淫色贴图	色情
粉红穴	色情
杀人犯	色情
新闻封锁	色情
抽插27岁处女妹妹淫叫不断	色情
fawanghuihui	色情
毛尻	色情
ｊｉａｎ ｘｉａ ｑｉｎｇ ｙｕａｎ	色情
抽插29岁处女meimei淫叫不断	色情
骚妇掰B	色情
fuck傻吊	色情
xinguangming鳥你	色情
本站10008多部激情电影全部免费试看三天	色情
温家保	色情
封神传说	色情
癡乳	色情
avatar	色情
毛李登辉	色情
粗大的阴茎与紧窄的阴道壁之间的剧烈磨擦	色情
毛联易	色情
操尼	色情
一九八九六四	色情
激情解码两性电影	色情
大 紀 元 新 聞 網	色情
小泽玛丽亚~闷绝痉挛无限制潮吹	色情
紅 色 恐 怖	色情
淫妻交换	色情
超级樂者	色情
wyd	色情
玩穴	色情
桑拿房的淫乱图片 免费母子淫乱图片	色情
幼男做爱妹妹做爱	色情
fuck社科院	色情
和两勇男玩39P	色情
魏京生	色情
老二	色情
SARS	色情
色情导航 av电影	色情
代开发票	色情
sheng zhe wu di	色情
北京xx網	色情
北美自由论坛	色情
诱惑视频	色情
cronous	色情
如果你未满35周岁请自觉离开。	色情
和两勇男玩4P	色情
kefu9you	色情
汉娃娃	色情
淫妻	色情
黄色免费淫奸电影我和女友干爽后再她妹妹	色情
周旋	色情
反革命	色情
PP电影	色情
婷婷激情俱乐部导航	色情
soma	色情
建国党	色情
人妻	色情
國產AV	色情
倖存	色情
彭珮云	色情
曰本	色情
民进党	色情
东洋屄	色情
成人片	色情
森水Cocoa	色情
罌粟	色情
鹿城黄站	色情
糞便	色情
学运	色情
免费淫 电影a片。母子淫奸乱轮现场	色情
强奸43岁处女全过程/淫妹阴毛小穴	色情
弟弟淫奸姐姐论坛	色情
我湿淋淋的阴道	色情
小浪穴┅大鸡巴	色情
林慎立	色情
神甲奇兵	色情
色窝窝	色情
本站10009多部激情电影全部免费试看	色情
我的小穴好爽	色情
身体障害者	色情
zhicheng163	色情
放尿	色情
杨帆	色情
虎虎虎~淫秽的身体 Tora-Tora Gold Vol。25 : Shizuku Natsukawa	色情
手指插的进小淫穴	色情
Dick	色情
蒋正华	色情
王鹤寿	色情
Q币	色情
抽插25岁处女meimei淫叫不断	色情
專政	色情
日本暴淫网	色情
许家屯	色情
gamemy	色情
淫奸熟睡的妈妈亚洲床上色情图库少女做爱	色情
胡启立	色情
成人网址导航	色情
暗黑之门：伦敦	色情
管理员	色情
朱駿	色情
西藏问题	色情
淫水橫溢	色情
性器肛门~原千寻、桜井	色情
高文谦	色情
龟头插入少妇阴道	色情
姐姐的嫩阴户	色情
我周容	色情
qeeloo	色情
動	色情
pk1937	色情
a片试看	色情
免费强奸电影	色情
妹妹乱伦理淫穴	色情
亞洲互動	色情
手记注册日韩5034部激情电影	色情
又粗又大的肉棒	色情
真封神	色情
寫真	色情
zhengwunet	色情
youxia	色情
天安門檔案	色情
黄大仙	色情
四川独	色情
尿	色情
Red Hot Jam Vol。 藤崎夕凪	色情
ｂａｏｐｉ	色情
Ｘ到喷屎尿	色情
MUGEN EX Vol。 8 美脚痴女 红音まい	色情
hkhk68	色情
毛可卡因	色情
回良玉	色情
李长春	色情
發@@掄	色情
淫荡少妇白洁	色情
王永生将军	色情
身寸	色情
法轮功靠	色情
公务员的工资	色情
轻舟快讯	色情
公车淫奸妹妹	色情
性交自拍	色情
少妇房中自淫，和两勇男玩1P，操得直叫爽 操日本淫女穴	色情
射雕淫女传	色情
代挂	色情
亚洲激情无码BT	色情
无套内射	色情
爆吧	色情
插　小姐	色情
高校暴乱	色情
淫荡俱乐部	色情
肉棒精液淫液阴精	色情
色猫	色情
成人淫乱小说	色情
肉蒲团	色情
黄色免费超级淫图	色情
毛懒教	色情
瞿秋白	色情
淫女炮圖	色情
一夜九次郎	色情
熟女乱伦联盟	色情
臭作	色情
沈彤	色情
龜頭	色情
小穴被插	色情
18男人momoB	色情
希特勒	色情
国家分裂	色情
姫野爱	色情
d f d z	色情
运营商	色情
曹刚川	色情
法**抡	色情
一边一国	色情
成人文學	色情
稻生美纪 - miki	色情
六月four日	色情
军民血腥冲突	色情
幹您娘	色情
周百刚	色情
六。四事件	色情
射进妈妈里面	色情
狂插喷爱液	色情
错B	色情
超性感裸体艳舞 孔裏唾梦 DANCE 2 アナリズ现场收音	色情
法**倫	色情
毛胡锦淘	色情
宗教	色情
韓國自拍無碼系列之二)	色情
烂游戏靠	色情
好粗大的肉棒	色情
操操XX	色情
卖B	色情
高潮集錦	色情
金山	色情
中科院	色情
ｍｏ ｈｕａｎ ｓｅｎ ｌｉｎ	色情
次郎	色情
穴门meinv图库	色情
姐姐	色情
精子射到妈妈的穴里	色情
快活林黄站	色情
毛王八蛋	色情
丁字褲翹臀	色情
航空母舰	色情
少女露嫩穴 少妇嫩穴 meinv的嫩穴	色情
网 特	色情
毛爷爷复活	色情
fuck外\挂	色情
fuck氵去	色情
亚洲贴图区月宫	色情
醬豬媳	色情
仆	色情
ｌｉｎｅａｇｅ2	色情
少妇大穴VS驴吊	色情
淫虎大型色站	色情
郭 岩 華	色情
狂插儿媳	色情
傻吊	色情
午夜激情妹妹	色情
自慰	色情
肉棒插入	色情
欧美激情淫色贴图区	色情
法碖功	色情
品色永远免费堂pin6 meinv发春激情3级片试看	色情
童颜巨乳	色情
遊戲送獎員	色情
悠游网	色情
少妇扒开阴道图	色情
无套自拍	色情
毛倭国	色情
Voyage	色情
非常漂亮的日本美少女，日起火！	色情
淫女刮毛	色情
發~輪	色情
肉棒插入肉洞	色情
91bb成人小电影	色情
去你的	色情
操那吗B	色情
meimei的阴户	色情
你姥姥的	色情
毛蒋经国	色情
熱血江湖	色情
fuck上你	色情
劳动保障部	色情
强*十八岁meinv护士看完保证你打飞机免费淫电影a片	色情
嫩B弓雖女幹	色情
日本淫妞	色情
粗肉棒 大鸡巴	色情
冯东海	色情
19dy淫色贴图	色情
夫妻电影	色情
AV女优和平凡男人1日结婚	色情
hai dao shi dai	色情
掯	色情
(人妻。com)人妻の情事2 夫以外の男に中出しされた妻たち	色情
triangleboy	色情
毛上你	色情
操朝鲜	色情
将肉棒插入漂亮的老师小淫嘴抽插数十次	色情
色meimei淫穴	色情
娇小鲜嫩的小屄洞	色情
大阴唇夹着大龟头	色情
干爽	色情
曾庆紅	色情
fuck台湾独立	色情
外—掛	色情
毛嫖客	色情
舔吮 乳房 干小穴	色情
ｈａｃｋｉｎｇ	色情
弟弟淫奸姐姐	色情
淫姐	色情
毛恶搞晚会	色情
我和jiejie	色情
滚那吗	色情
唐柏桥	色情
舔舐着阴道内壁	色情
fuck生鸦片	色情
六四屠杀	色情
毛几届中央政治局委员	色情
av贴图	色情
性感诱惑	色情
美女偷拍成人小说激情网香港激情图源成人色情论坛脱衣美女做愛	色情
運營组	色情
花样性交	色情
大 參 考	色情
豪乳	色情
濫B	色情
强奸免费淫电影	色情
插那吗逼	色情
非常三國	色情
和meimei肏穴	色情
T。M。D	色情
强*十八岁美女护士看完保证你打飞机免费电影网站	色情
毛龟头	色情
禁书	色情
錢運錄	色情
成人小說	色情
性情中人	色情
周總理	色情
毛天安门档案	色情
Qqyinsu	色情
淫奸小姨子	色情
婬乱军团	色情
我含着阴茎	色情
淫电影艳情电影	色情
陌生做爱在车里发生	色情
你是鴨	色情
他NND	色情
激情淫洞网站	色情
動漫色圖	色情
最牛钉子户	色情
勁舞	色情
可愛均整清純派meinv可愛均整清純派meinv	色情
嫩屄	色情
反革命暴亂	色情
大鸡巴插小穴	色情
捅B	色情
你媽的	色情
测绘局	色情
色情导航 导航	色情
bing feng chuan qi	色情
9游	色情
老兵	色情
騰訊	色情
骚浪淫水的小屄儿	色情
蓋世太保	色情
机战	色情
手机复制	色情
玉女吹箫的姿势和技巧图	色情
毛二乙基酰胺	色情
陽精	色情
李 小 朋	色情
fuck台独	色情
王军涛	色情
极品成人电影	色情
VIP特区 激情在线	色情
插　护士	色情
钱运录	色情
鲍鱼	色情
颜射	色情
9之游	色情
美女主持脱衣	色情
军民冲突	色情
猥褻	色情
肛門拳交	色情
屌七	色情
用手指玩弄着阴户	色情
毛林业局	色情
GAMEMASTE	色情
舔雞巴	色情
ｂａｓｔｅｒｄ	色情
淫电影论坛	色情
淫奸少妇论坛	色情
毛东突组织	色情
陰屄	色情
熟美婦淫交實錄	色情
真三国无双OL	色情
小穴流出	色情
奇迹世界	色情
毛万税	色情
Transformaition 栗田Hiromi	色情
勁舞世界	色情
大鸡吧插妹妹淫屄	色情
猛嫩穴把肉棒包得紧紧	色情
明诺东方	色情
八九年那個春夏之交	色情
毛胡主席	色情
淫液流入	色情
fuck水利部	色情
法(輪)功	色情
在线淫电影 淫奸电影 黄色电影	色情
法@@伦	色情
法@@掄	色情
肉棒里插肉洞	色情
淫奸妹妹电影论坛	色情
生春袋	色情
网络公祭	色情
欧美淫色贴图	色情
日你全家	色情
毛皮条	色情
运營组	色情
汪东兴	色情
大 参 考	色情
朱胜文	色情
新视野工作室	色情
在线淫穴	色情
中宣部	色情
藤井せいら - ボルテージ X	色情
……好爽喲 插穴	色情
妹妹淫图	色情
阴茎在阴道快感	色情
发$沦	色情
他妈的靠	色情
叼你	色情
新人调教 Red Hot Jam Vol。9彻底调教凌辱人靓逼美	色情
少妇被操穴	色情
孙大午	色情
张梅颖	色情
毛发抡	色情
毛肉棍	色情
毛鸡鸡	色情
东亚病夫	色情
成人贴图网站	色情
大乳	色情
少妇床上欲火难耐自摸图	色情
騷乳	色情
騷姨媽	色情
毛蒙古独立	色情
Trickster	色情
輪姦	色情
毛贾庆林	色情
保釣	色情
ever quest	色情
ｍｅｎｇ ｈｕａｎ ｘｉ ｙｏｕ	色情
十八电影掰穴特写红免费性视频聊天激情少妇图	色情
虐奴	色情
我操了美丽的女律师	色情
台湾一夜激情成人聊天室	色情
夏夏娱乐免费黄站	色情
妈的B	色情
濕透的內褲	色情
madelove	色情
meinv淫水狂流	色情
又长粗的肉棒	色情
范田紗~120％!H喜不自禁住在一起日記	色情
投毒杀人	色情
激情3级片试看	色情
大学骚乱	色情
H動漫	色情
pao pao dao	色情
在线免费观看性感mo特日本性感奶霸图片骚	色情
亚洲色	色情
臺灣國	色情
GirlDV热门成人影片	色情
分裂祖国	色情
日本激情成人乱伦	色情
88jb	色情
香港成人色网址大全	色情
天晴数码	色情
炮友	色情
东突，免费淫色情电影 令人喷血的春宫108姿势(组图)18岁禁看	色情
铁血三国志	色情
无码	色情
毛枪决现场	色情
法^纶	色情
激情淫色论坛	色情
徐邦秦	色情
易玩网	色情
和两勇男玩35P	色情
操母狗	色情
魂online	色情
aszol	色情
錢 達	色情
夠酷GOQO	色情
大花逼	色情
口交	色情
幼女性交	色情
日本大型黄色meinv做爱	色情
温家堡	色情
丁石孙	色情
骚浪美女	色情
天安门惨案	色情
丰满小妹的丰褪美腿 嫩得流水的小妹妹	色情
黄永胜	色情
毛小鸡鸡	色情
亚洲色meimei	色情
发$仑	色情
三個呆婊	色情
黑社会	色情
遊戲管理者	色情
红海湾	色情
狂操穴喷出阴精	色情
白小姐	色情
天暢	色情
红灯区	色情
985985	色情
豔照	色情
免费黄色网站电影	色情
无疆界	色情
奴隷调教	色情
南蛮	色情
毛发正念	色情
淫妹妹电影论坛	色情
参事室	色情
摸你	色情
国防部	色情
自杀指南	色情
操波霸	色情
余英时	色情
审查	色情
护士mm乱淫	色情
嫩鮑魚	色情
Duty Vol 50背徳の近亲相奸	色情
ａｓｓｈｏｌｅ	色情
黃色圖片	色情
卖国求荣	色情
ｗｗｗ。ｇｐｃｈｉｎａ。ｎｅｔ	色情
娇嫩的蜜穴 肉穴	色情
ａｉｄｓ	色情
毛特码	色情
迅雷下载淫乱电影	色情
狗剩	色情
肉棒插 淫水	色情
错那吗比	色情
泡沫经济	色情
口含鸡巴 插入阴道	色情
性爱图片	色情
kqking	色情
fuck小肉粒	色情
eight仙	色情
蝴蝶谷黄站	色情
尖阁列岛	色情
xinguangming鸟你	色情
毛淫秽	色情
在线免费成人电影	色情
日本色诱女郎图库激情成人视频聊天室	色情
神话R。Y。L	色情
八九民运	色情
肉棍子	色情
自拍淫荡骚妇们的性福	色情
性交贴图	色情
乡巴佬	色情
腾人	色情
meinv嫩穴淫水直流	色情
韩天石	色情
fuck色情小电影	色情
风骚少妇	色情
Whitey Whitey	色情
毛体育总局	色情
天安门母亲运动	色情
meinv电影	色情
肏烂你的屄	色情
注册免费淫电影	色情
新疆独立	色情
操林	色情
色网阴道特写强奸21岁处女全过程	色情
a级电影	色情
操车臣	色情
肉缝 蜜穴 肉棒	色情
中华	色情
玩3p色链	色情
淫亂工作	色情
插屄好舒服	色情
激情裸聊 性爱电影	色情
狂插妹妹的小穴	色情
淫荡女生	色情
alod	色情
淫奸电影	色情
免费淫电影吴宗宪搞笑语录(22禁看)	色情
TEsT	色情
動乱	色情
粉红的的奶头粉嫩的阴唇	色情
日本成人激情网站	色情
镇压	色情
一党专政	色情
插妹妹图	色情
李 祿	色情
野外操B更刺激	色情
小姐打飛機	色情
佳静安定片	色情
暴乱	色情
希望之聲	色情
法^^纶	色情
殘废	色情
阿芙蓉	色情
foutre	色情
劉延東	色情
看棋器	色情
Jiaochun	色情
强制执行 女体崩壊~YUU Vol。1	色情
欲仙欲浪	色情
中华大地	色情
好紧的阴道	色情
毛鸟gM	色情
马时敏	色情
调教虐待	色情
┅插┅小穴┅插我	色情
fuck驶你爸	色情
毛流氓	色情
民主黨派	色情
肉棍干騷婦	色情
熟母	色情
那嗎錯比	色情
王瑞林	色情
本站10003多部激情电影全部免费试看三天	色情
發@侖	色情
日本情色论坛	色情
僵贼民	色情
壮汉给纯情处女开苞见血	色情
外掛	色情
血b	色情
骚洞	色情
肉蒲團	色情
淫乱潮吹	色情
国家主要部委	色情
女激情淫影片下载	色情
高莺莺	色情
法$輪	色情
杨白冰	色情
肉棒一阵猛烈的抽插	色情
屌毛	色情
粉嫩美少女穴让你插	色情
空中小姐的淫荡性生活	色情
外　挂	色情
扑哧一下鸡吧操进了逼里	色情
嫩女~嫩屄~插的红肿喷浆	色情
黃色文學	色情
高俊	色情
淫色成人网址导航	色情
干妳娘	色情
huanet	色情
凸点装	色情
┎	色情
奧巴馬	色情
ｓａｒｓ	色情
轮干	色情
拉姆斯菲尔德	色情
玉女心經	色情
ｘｉｎｇ ｊｉ ｊｉａ ｙｕａｎ	色情
激情书屋男女做爱片段	色情
大龟头在我的阴道口来回磨擦	色情
美國之音	色情
鑽插	色情
毛李长春	色情
干老师的穴	色情
スクールガール 直美	色情
淫奸………啊 好舒服	色情
小穴疯狂地吮吸着我的阳精	色情
毛普京	色情
谭震林	色情
插穴止痒	色情
情妇	色情
激情在线	色情
ｌａｓｔｃｈａｏｓ	色情
身障	色情
中獎	色情
黑点	色情
舔鸡巴	色情
她妈地	色情
Ji女	色情
打倒中国共产党	色情
茎候佳阴	色情
連続失禁	色情
亚洲激情BT	色情
语音激情视频聊天室	色情
射顏	色情
免費A片	色情
xin chang zhi ye wang	色情
电车之狼	色情
吳 官 正	色情
shemale	色情
插 干jiejie 好爽	色情
meng huan guo du	色情
插妈妈的小穴	色情
suck	色情
激插	色情
87bb成人小电影	色情
你的肉棒干	色情
少女床上自拍	色情
大龟头碰到阴户底部最敏感的地方	色情
小泽玛丽亚7~淫乱的肉体	色情
爱的奉献	色情
操吹箫	色情
神风- Kamikaze Premium Vol。 32 : 一色Azusa	色情
亲 美	色情
eve	色情
18dy电影	色情
楊帆	色情
狂操淫荡女	色情
18禁	色情
腾讯	色情
干妳	色情
上访	色情
讲法	色情
少修正	色情
唐人街情色导航	色情
张朝阳	色情
…你的穴太紧了	色情
交配	色情
劉淇	色情
姐姐的屄	色情
色妹妹大型黄站	色情
大鸡巴顶进妹妹的花心	色情
紫瑞专业	色情
巨商	色情
精液直射入她的小穴深处	色情
viprxjh	色情
嘩嘩曼	色情
fuck孙中山	色情
若叶~Princess Collection(1163)	色情
淫色全免费	色情
butthead	色情
曼施坦因	色情
新华内情	色情
娼	色情
香港色情影星meinv裸体	色情
激情淫少女穴	色情
共和	色情
干美女小穴	色情
操他	色情
肉棒在小穴四周游移轻撩	色情
毛叫小姐	色情
激情电影在线观看	色情
美女 淫穴	色情
激情裸體	色情
色网阴道特写强奸22岁处女全过程	色情
法十轮十功	色情
幼男做爱meimei做爱	色情
AIDS	色情
日本激情视频聊天室	色情
亞洲色	色情
小淫穴	色情
黄色免费淫奸电影我和女友干爽后再她meimei	色情
耶蘇	色情
天之遊俠	色情
全身一阵颤抖 大鸡巴	色情
阳物	色情
毛干妳妈	色情
遊龍線上	色情
喪服妻欲望	色情
钱达	色情
┪	色情
紅月	色情
歡樂潛水艇	色情
插的姐姐好爽	色情
肉棒好粗	色情
卫星接收器	色情
戳那吗比	色情
麥角酸二乙基酰胺	色情
外$挂	色情
猛插	色情
┚	色情
ｗｗｗ。ｇｐｃｈｉｎａ。ｃｏｍ	色情
無碼h漫	色情
群P	色情
美神ルナ	色情
狂插白嫩幼女bb还射乳	色情
浪妻淫女	色情
魔幻森林	色情
模拟机	色情
日本巨乳淫女	色情
大粗肉棒插入阴户	色情
骚乳	色情
屄	色情
打手枪	色情
一夜激情成人聊天室	色情
淫阴贴图	色情
激情裸体	色情
毛贺国强	色情
陈伯达	色情
浪女叫春成人招妓网色性网电影性暴力电影	色情
一起玩	色情
美女穴	色情
欧女乱欲	色情
婊子养的	色情
手机注册看性爱电影	色情
楊震	色情
干 淫穴好舒服	色情
學生愛國者運動	色情
姦夫淫婦	色情
法^沦	色情
遊戲米果	色情
成人激情电影网	色情
免费淫奸黄色电影a片	色情
popoming	色情
弟弟淫奸jiejie穴	色情
操逼电影	色情
骚BB免费色电影	色情
插	色情
沒有人權	色情
fuck台湾帝国	色情
meimei的嫩阴户	色情
GAMEMASTER	色情
抽插40岁处女妹妹淫叫不断	色情
经典免费淫电影下载	色情
18DY性爱电影	色情
和两勇男玩36P	色情
司马义•铁力瓦尔地	色情
狂操搔逼妈妈	色情
13点	色情
淫民俱乐部日韩激情片	色情
抽插43岁处女妹妹淫叫不断	色情
MAKINGLOVE	色情
毛驶你爸	色情
puneta puneta	色情
嫩BB	色情
肉棒在子宫口游荡	色情
舔逼	色情
毛回回	色情
法轮	色情
CNN	色情
帶炼	色情
fuck身份生成器	色情
足球經理	色情
淫荡┅好舒服	色情
民警当副院长	色情
天翼之鏈	色情
一国两制	色情
情报	色情
小穴淫图	色情
皓宇互动	色情
儿子粗大的肉棒	色情
宏 法	色情
生殖器	色情
Kamikaze Premium Vol。 25:特級神風~榊彩彌	色情
强奸42岁处女全过程/淫妹阴毛小穴	色情
┢	色情
鈤	色情
妹妹小穴好紧	色情
烂b	色情
龙洲影院日本娱乐性免费	色情
操你老妈	色情
姐弟激情淫乱	色情
插B	色情
厕所盗摄护士姐姐性感美腿图 肉丝美腿艳情淫欲	色情
黄色	色情
Kamikaze Girls Vol。 27高清晰版本	色情
H动漫	色情
捅死你	色情
汕尾事件	色情
fuck死gm	色情
邹家华	色情
淫欲世家	色情
d7se淫色贴图	色情
成人論壇	色情
欲仙欲死	色情
rxjh	色情
毛鲍	色情
毛奸淫	色情
美穴	色情
官逼民反	色情
法抡	色情
本站10011多部激情电影全部免费试看三天	色情
男人若妻夢交下载	色情
洗浴间爽奸白嫩美乳少女	色情
捏你雞巴	色情
本站10008多部激情电影全部免费试看	色情
金瓶梅情色網	色情
毛李岚清	色情
Red Hot Idol Vol 1	色情
SKY宫泽Keito 超美系模特儿初无修正引退纪念作	色情
干保姆小穴	色情
淫奸jiejie论坛	色情
发^抡	色情
阴部	色情
萬人暴	色情
足脚交	色情
天安門屠城	色情
免费淫奸女Ａ片段试看 强*十八岁美女护士	色情
fuck售ID	色情
龜头	色情
365成人贴图	色情
fuck新唐人	色情
清纯派美女可爱的让人想狂干她！【RMVB/195MB】	色情
fuck新闻出版	色情
狗日	色情
Red Hot Jam Vol。6 露出初体验~Chia	色情
激情免费电影	色情
hun luan mao xian	色情
共荣圈	色情
玉蒲团 玉女心经	色情
网易	色情
柳下惠	色情
致幻剂	色情
一卡多号	色情
鸡巴……插死我了	色情
自民党	色情
雨星网	色情
清晰內射	色情
日她	色情
尼米兹	色情
fuck傻子	色情
仑功	色情
弓虽女干	色情
情色成人论坛淫图导航	色情
手记注册日韩5029部激情电影	色情
盜撮	色情
洪志	色情
免费免注册淫电影	色情
卡通动漫meinv淫乱	色情
东方红时空	色情
新生网	色情
yong bing chuan shuo	色情
王 秀 麗	色情
巨额骗储	色情
新天翼	色情
欧美淫图	色情
王宝森	色情
fuck新华内情	色情
喷精 3p	色情
性愛	色情
独占动画~女热大陆 file 2	色情
马万祺	色情
妹妹等你大鸡吧来插	色情
meimei美图网	色情
阿兵哥言语录	色情
女教師 レイプ 輪姦	色情
中國恐怖組織	色情
揭批书	色情
最新99bb)有名女优~及川奈央-痴女教师	色情
日本骚货	色情
女巨乳女教師	色情
风骚小阿姨	色情
摩门教	色情
新黨	色情
ｗｕ ｌｉｎ ｗａｉ ｚｈｕａｎ	色情
亚洲免费淫色电影下载	色情
毛烂屄	色情
龟孙子	色情
ｔｉａｎ ｌｏｎｇ ｂａ ｂｕ	色情
卢跃刚	色情
少女被强奸到高潮时偷拍小A片免费淫电影a片	色情
汇款	色情
去你妈	色情
又猛插几下	色情
Shine	色情
fuck水去车仑	色情
手记注册日韩5025部激情电影	色情
性欲喘息女教師	色情
jy2	色情
毛干GM	色情
性无能	色情
沦功	色情
法~~侖	色情
吴 宏 达	色情
点击观看*林心如做爱*色情电影*免费淫 电影	色情
travesti	色情
操抽你丫的	色情
毛欢城互动	色情
鷄巴	色情
胡主席	色情
fuck他马的	色情
张 林	色情
合成淫色贴图	色情
陆委会	色情
鳥GM	色情
肉棒在阴道中疯狂抽射	色情
fuck靠	色情
省長兒媳婦	色情
GAMEmaster	色情
法崘功	色情
性感meinv淫穴	色情
毛激情电影	色情
做爱电影	色情
妹妹做爱	色情
屎	色情
淫奸妹妹穴	色情
Kamikaze Girls Vol。 30~中野美奈	色情
油田总部	色情
3P	色情
777黄站	色情
獸	色情
淫痴	色情
淫奸meinv	色情
毛烂B	色情
人大	色情
矽穀動力	色情
淫水狂流	色情
renewal	色情
偷情	色情
法@@抡	色情
色情服务	色情
sf	色情
小浪穴 插死 人家了	色情
毛希拉克	色情
强奸41岁处女全过程/淫妹阴毛小穴	色情
zirui	色情
ｓａｏｈｕｏ	色情
毛生春袋	色情
E块冒险	色情
十三点	色情
meng huan xi you	色情
擠母奶	色情
郭 平	色情
ｓｈａｏｌｉｎｃｎ	色情
ping guo pai	色情
fuck新手指导员	色情
小穴	色情
淫女浪穴	色情
董建华	色情
情色 性息	色情
美女性交极品大片	色情
慰安妇	色情
情色影院 导航 18岁禁看	色情
成人色情导航	色情
淫浪女 淫妻浪女 于东 浪女淫叫 淫妻……漫画 淫色贴图东方淫色	色情
丝袜足交	色情
专制	色情
淫穴 夹 好爽	色情
性色俱乐部	色情
鸡吧顶住阴道口	色情
陈丕显	色情
曹你	色情
肥美的阴唇	色情
個批	色情
魔鬼曲線風騷女优青木玲 - FACE 68	色情
性爱护士	色情
掰穴皮卡丘	色情
海天英雄传	色情
傅鐵山	色情
毛光明日报	色情
梅花屄	色情
Suck	色情
毛李鹏*	色情
淫西	色情
韓 東 方	色情
懶趴	色情
淫母	色情
轮流执政	色情
ON9	色情
联合国	色情
肉棒噗嗤一声滑入阴道	色情
捅入她的阴道里	色情
毛拉登	色情
激情淫色网站导航	色情
ryl	色情
ｘｉａｎ ｊｉｎｇ ｃｈｕａｎ ｓｈｕｏ	色情
毛对日强硬	色情
李紅智	色情
日本淫荡少妇	色情
娇妻偷欢超爽日本电影	色情
camon	色情
不用注册免费淫 电影	色情
成人百強	色情
孟建柱	色情
輪流執政	色情
毛卵	色情
发抡	色情
刚比	色情
meimei穴	色情
操蠢猪	色情
fuck天安门屠杀	色情
Painful Groins Getting Pounded : Akira Shiratori 白鸟あきら	色情
毛阳具	色情
肉洞深处不断地蠕动	色情
发**轮	色情
蔣正華	色情
搶 糧 記	色情
大东亚共荣	色情
少妇房中自淫，和两勇男玩20P，操得直叫爽 操日本淫女穴	色情
淫欧美淫暴	色情
郭 岩 华	色情
紅頂商人	色情
插嫩穴 淫水流	色情
hun	色情
你娘的	色情
瓦良格	色情
dse淫乱小姨小说	色情
乳房急促而有节奏的起伏着	色情
傳銷	色情
龟头抵制花心顶住子宫口	色情
石戈	色情
手记注册日韩5009部激情电影	色情
歡迎光臨亞洲瘋情	色情
浩天銀科	色情
前任男友	色情
妈逼	色情
肉棒的抽送 淫乱 用力干	色情
騷女	色情
方舟子	色情
kong que wang	色情
毛日本RING	色情
哥哥的肉棒好长啊	色情
恥辱醫護免费下载	色情
赣江学院	色情
阿姨的阴道好紧啊	色情
fosaon	色情
草嫣	色情
馬凱	色情
東條英機	色情
Aids	色情
毛烂屌	色情
免费偷窥网	色情
人大常委	色情
肉棒在阴道口游荡	色情
里根	色情
共和国卫士	色情
凌锋	色情
来爽我	色情
疯狂姐姐淫穴	色情
dong fang chuan shuo	色情
法论攻	色情
一黨專制	色情
妈妈你的穴好紧	色情
抚弄后插入小穴	色情
吞精騷妹	色情
刀online	色情
吳 方 城	色情
ｑｑｙｉｎｓｕ	色情
三民主义	色情
mo fa qi bing	色情
死	色情
國權	色情
黃色網站	色情
笨逼	色情
狠狠地肏	色情
最新成人激情电影网站	色情
国际法院	色情
妹妹穴	色情
淫乱护士激情电影	色情
尖閣列島	色情
色情排行榜 色情导航	色情
本站10007多部激情电影全部免费试看	色情
黨中央	色情
毛太监	色情
bankai	色情
回民	色情
早洩	色情
免费激情电影	色情
支持台湾	色情
猛地插入了她的肥穴	色情
FLG 媽批	色情
做爱爽图	色情
強姦你	色情
爱女人	色情
小穴 肉棒 插穴用力插	色情
舆论钳制	色情
肉棒狂插嫩穴	色情
鹽酸二乙醯嗎啡	色情
Government	色情
聖戰	色情
夫妻俱乐部	色情
色图专区	色情
打飞机	色情
毛反封锁技术	色情
肉棒在小穴里好爽	色情
激情成人视频聊天室	色情
陰毛	色情
下载黄色淫乱电影	色情
毛新华内情	色情
大阴唇姐姐	色情
puSSy puSSy	色情
毛一夜情	色情
淫奸少女穴	色情
伊斯兰	色情
藓鲍	色情
天安门事件1989	色情
劲舞团	色情
操b指南	色情
AV女优	色情
re xue jiang hu	色情
金毛穴	色情
交换夫妻	色情
乱交	色情
免费成人两性影院	色情
官方工作员	色情
欧美激情淫色贴图网	色情
插入小姐的嫩穴	色情
毛龙新民	色情
超激情电影快速注册 在线观看爽!爽!爽!！	色情
測試員	色情
moxiang	色情
谁知道激情网站	色情
政府無能	色情
……好舒服 舔穴	色情
美丽女教师的性经历	色情
毛列宁	色情
舌尖刮著陰唇上的淫水	色情
ｆｉｌｓ ｄｅ ｐｕｔｅ	色情
法~~倫	色情
法~~沦	色情
谢选骏	色情
外~挂	色情
插护士穴真爽	色情
ggq	色情
space	色情
狂插林心如穴	色情
毛贺龙	色情
偷情網	色情
周铁农	色情
插的妈妈好舒服	色情
摩門教	色情
干到	色情
首长	色情
爱国者	色情
舔她小穴	色情
锤锤	色情
注册激情电影	色情
轩辕二	色情
万润南	色情
meinv鸡吧图	色情
少妇	色情
你老母	色情
鬼畜轮奸	色情
卡通美女淫乱图	色情
AV女优-杏子	色情
meinv主持25小时全天激情热舞	色情
qqpp	色情
强奸十八岁meinv护士看完保证你打飞机免费电影网站	色情
性虎色網	色情
王克	色情
淫女露穴	色情
你色嗎	色情
馬克思	色情
法侖功	色情
骚女叫春	色情
藏青会	色情
zl-fm。com	色情
法踚功	色情
欢迎点击进入观看/林/心如/20岁处女偷拍/免费A。B片	色情
操薄一波	色情
臭b	色情
毛弓虽女干	色情
GN	色情
610办公室靠	色情
┄	色情
刘丽英	色情
援交薄碼	色情
原子能机构	色情
靠母	色情
少妇房中自淫，和两勇男玩11P，操得直叫爽 操日本淫女穴	色情
美国小姐淫荡舔乳照	色情
毛是鸡	色情
一夜情聊天室	色情
ｗｕ ｊｉｎ ｄｅ ｒｅｎ ｗｕ	色情
避孕	色情
人妻榨乳	色情
胸涛乳浪	色情
ｍｅｎｇ ｈｕａｎ ｚｈｉ ｘｉｎｇ	色情
mir	色情
fuck鲜族	色情
公審李鵬	色情
鸡毛信文汇	色情
fuck特别公告	色情
運營者	色情
俏臀摄魄	色情
禁断少女	色情
肉棒 插得太深了	色情
幹你妈b	色情
survivalproject	色情
冊那	色情
邓发	色情
空中小姐的淫蕩性生活	色情
台湾盲人美女在家疯狂做爱	色情
毛统计局	色情
视讯情人聊天室	色情
１８歲淫亂	色情
锤子	色情
成人激情网站	色情
成人色情网	色情
法@沦	色情
狂插荡护士	色情
网域	色情
成人网站排行榜	色情
东热meinv一个比一个强	色情
法~轮	色情
韩桂芝	色情
西藏分裂	色情
亚洲情色	色情
毛斧头镰刀	色情
運營組	色情
高丽棒	色情
┆	色情
下三烂	色情
叶群	色情
婷婷激情淫液	色情
柔软红嫩的小阴唇	色情
毛烂逼	色情
du shi 2046	色情
LB	色情
猛插小嫩穴	色情
金瓶梅5	色情
布莱尔	色情
積存的巨乳妻子積存的巨乳妻子	色情
插在小穴里的肉棒	色情
欧美成人漫画贴图区	色情
刘全喜	色情
徐光春	色情
成人午夜电影	色情
援交妹	色情
成人激情视频聊天	色情
摇头玩	色情
干老师的穴好爽	色情
姐姐的小屄	色情
毛拍肩神药	色情
小姨子淫色导航	色情
Anal Asspirations 7	色情
少女艳星诱惑色图	色情
成人在线免费淫电影	色情
gameMASTER	色情
63xp。com 电影免费	色情
剑侠情缘II	色情
计生风暴	色情
大鸡吧插又肥又嫩的屄儿	色情
插你爺爺	色情
性虐待	色情
毛社保基金会	色情
蜜汁 舔穴 塞入	色情
成人情色网站	色情
dekaron	色情
收缩的阴道中抽出肉棒	色情
免费成人两性电影	色情
洗钱	色情
毛一鲜	色情
kai tian	色情
成人两性电影	色情
儿子顶到姐姐的花心	色情
屎你娘	色情
你大爺	色情
screw	色情
大 纪 元 新 闻 网	色情
掰开她的小穴	色情
秦晋	色情
插进	色情
操大B	色情
sm女王	色情
插 7p	色情
又肥又紧的阴道	色情
阿姨和我乱伦理小说	色情
淫奸护士小说	色情
人民幣	色情
大富翁	色情
江青	色情
U   R靠	色情
民运	色情
慾火	色情
淫獸學園	色情
淪	色情
gth	色情
粗肉棒阴户	色情
熟女乱伦	色情
情色导航 激情爽电影	色情
妹妹的小阴户	色情
毛李山	色情
变态心魔女仲村 生中出	色情
抽插50岁处女meimei淫叫不断	色情
raycity	色情
激情淫色文章网站	色情
小騷比	色情
中天万方	色情
外？？掛	色情
Tibet国	色情
金瓶梅3	色情
幼交图嫩女兽交	色情
毛毛XX	色情
公车上干女司机	色情
大鸡巴 干进 花心	色情
傅杰	色情
wstaiji	色情
刘山青	色情
性骚扰	色情
yuanming喷你	色情
田纪雲	色情
廖晖	色情
胸部	色情
火辣写真	色情
肉棒猛烈拔插	色情
秘书自慰被偷拍	色情
朱琳	色情
插你爷爷	色情
性感誘惑	色情
本站10010多部激情电影全部免费试看三天	色情
李弘旨	色情
動亂	色情
操你爷爷	色情
外\挂	色情
┹	色情
公车淫奸女学生	色情
冒险岛	色情
师春生	色情
搞b	色情
氣性坏疽病	色情
mystina	色情
105bb成人小电影	色情
jin yong qun xia zhuan	色情
少妇贴图穴论坛 欧美淫色贴图区	色情
毛江择民	色情
和两勇男玩17P	色情
処女	色情
毛孙逸仙	色情
淫荡的嫂子	色情
操妻	色情
李总理	色情
删号	色情
台湾成人19贴图	色情
射精	色情
嗎比	色情
ｚｈｅｎ ｆｅｎｇ ｓｈｅｎ	色情
公务员工资	色情
回民人吃豬肉	其它
致幻劑	色情
顶进嫂子的花心	色情
毛孙中山	色情
阴道夹的好紧	色情
台湾20岁成人	色情
激凸走光	色情
日本姐弟乱伦小说	色情
利瓦伊汉	色情
胡平	色情
sperm	色情
毛台湾共产党	色情
高潮集锦	色情
大花B	色情
一党专制	色情
激情淫色小穴	色情
姐弟淫乱	色情
毛李瑞环	色情
捏弄	色情
罗荣桓	色情
salop	色情
校园激情淫色	色情
毛发展研究中心	色情
日你奶奶	色情
陰水	色情
fuck透视眼镜	色情
yong heng	色情
吴　仪	色情
后面插入处女的肉穴	色情
毛火棒	色情
三个代表	色情
性交做爱	色情
江八條	色情
老师含住我的小弟弟	色情
情欲奸岳母	色情
┶	色情
塞你母	色情
eqsf	色情
自慰抠穴	色情
shen qi	色情
杨月清	色情
yuckfu	色情
小穴被阴茎顶住	色情
邢铮	色情
ｃａｏ ｂ	色情
漂亮。女記者採訪時被逼姦	色情
大城舞衣子(有碼無碼)大合輯~~~超優!!(可分開下載哦!!!)	色情
成人之家	色情
免费看激情视频免费成人做爱	色情
ｋａｒｍａ	色情
怎样延迟射精19岁以下禁	色情
1989	色情
徐水良	色情
戳你	色情
…快插我淫穴…	色情
小鸡巴	色情
太王四神记	色情
骚穴淫液	色情
幹的爽	色情
大波騷婦	色情
驶你公	色情
張 伯 笠	色情
激情电影	色情
日本激情电影	色情
１９８９ 天安门	色情
發$$倫	色情
淫水直流	色情
法*抡	色情
淫花宫色女中心	色情
老母	色情
feng shen bang	色情
和两勇男玩26P	色情
ｚｕ ｑｉｕ ｊｉｎｇ ｌｉ	色情
ke luo si	色情
Taiwan国	色情
NEWSPACE	色情
Client Server	色情
大师	色情
反攻大陆	色情
儿子顶到阿姨的花心	色情
兩腿之間	色情
久之遊	色情
毛人大	色情
放蕩	色情
丁加班	色情
干死 狂插 操	色情
日朱骏	色情
本站10001多部激情电影全部免费试看三天	色情
赵小明	色情
日本激情淫色贴图	色情
发@@轮	色情
刘青	色情
小嫩雞	色情
半夜我把龟头插进妹妹的深处	色情
激情淫色合成贴图	色情
操淫荡少妇 操淫荡meimei 操淫荡jiejie 操淫荡护士 操淫荡 空姐操 老师操女老师 学生操老师 操老师小说	色情
天皇陛下	色情
免费淫色妹妹电影网	色情
慾	色情
淫奸小姨子电影	色情
言论自由	色情
明慧网	色情
nacb	色情
發~~掄	色情
佛展千手法	色情
傻瓜	色情
去氧麻黃堿或安非他命	色情
干他妈	色情
潤星	色情
代链	色情
插gM	色情
大肉棒……好粗	色情
游戏米果	色情
中國共產黨	色情
毛干你	色情
乳此丝袜	色情
粗制吗啡	色情
午夜激情美穴	色情
性爱　电影	色情
抽插34岁处女meimei淫叫不断	色情
棉条	色情
吗啡碱	色情
密宗	色情
躶	色情
meinv插穴	色情
吴 百 益	色情
發正念	色情
鹿城百家性大型网站	色情
总局	色情
毛李宏志	色情
成人情感裸女裸聊图片	色情
街头扒衣	色情
怎样延迟射精24岁以下禁	色情
幹你老母	色情
administrator	色情
人民礼堂	色情
中华真实报道	色情
毛观世音	色情
淫奸meinv图 淫奸刘亦菲	色情
bukake	色情
一黨獨裁	色情
美丽世界	色情
小穴好紧	色情
魔兽世界	色情
GameMaste	色情
穴爽	色情
發~~論	色情
艷情小說	色情
釣魚島	色情
極品波神	色情
打倒中國共產黨	色情
激情文学区 暴乳母娘 国外淫色贴图网址	色情
免费看淫电影	色情
干ＧＭ	色情
浮夸风	色情
毛王兆国	色情
我的小屄儿好痒	色情
中华民国	色情
法*綸	色情
夫妻乱交	色情
瀨名	色情
嫩穴肉缝	色情
賣B	色情
气性坏疽病	色情
干牠	色情
嫩B弓虽女干	色情
我也要泄了┅┅喔	色情
独裁政治	色情
中国留学生--张丽 双插	色情
毛亲民党	色情
毛舔西	色情
总理	色情
日本精選無碼DVD	色情
淫b	色情
江油余震	色情
日本淫色电影	色情
龙虎靠	色情
干死CS	色情
谷牧	色情
Kamikaze_Girls_Vol。12	色情
特种部队	色情
新闻办	色情
毛换妻	色情
激情动漫成人	色情
狂操操小小姨穴	色情
欧美成人激情网站	色情
毛基督	色情
午夜情人	色情
车仑	色情
粗大的鸡巴穴洞	色情
淫奸meimei论坛	色情
ｑｑ自由幻想	色情
日领馆	色情
一起玩遊戲網	色情
先奸后杀	色情
毛联合国	色情
Kao	色情
龟头顶在花心深处	色情
肉棒插进湿润花蕊	色情
毛鸡掰	色情
丰满的视频聊天主持	色情
身份生成器	色情
香港情色俱乐部	色情
国土资源部	色情
月光宝盒	色情
抽插著阿姨的淫穴	色情
18岁 青▲学院中学1年生	色情
淫浪少妇和医生疯狂做爱	色情
学生淫图	色情
毛系统	色情
插進	色情
乳波臀浪	色情
免费淫色电影	色情
fuck傻比	色情
最新一本道)超正MODEL系列 仲里愛	色情
谋略高手	色情
gan你	色情
粗……肉洞	色情
獨立	色情
曰gＭ	色情
淫电影//教你怎样延迟射精	色情
淫蟲	色情
淫液从密穴 骚穴 嫩逼里流出来	色情
激情XXX电影(	色情
黎阳评	色情
发改委	色情
免费淫电影在线观看	色情
姐姐的阴道好紧啊	色情
操狗	色情
亲吻小屄	色情
装屄呢	色情
射入阴道里	色情
xinguangming	色情
毛梅花网	色情
成人网站导航	色情
法倫	色情
罢食	色情
特別公告	色情
群阴会	色情
做愛自拍	色情
毛日本鬼子	色情
八嘎	色情
滕武	色情
十八淫妹电影	色情
ｓｈｅｎ ｍｅ ｓｈｅｎ ｍｅ ｄａ ｍａｏ ｘｉａｎ	色情
瞄準她的肉穴插了進去……	色情
拉法叶舰	色情
贛您娘	色情
mabinogi	色情
fuck透视软件	色情
千年	色情
mo xiang	色情
ｄｏｎｇ ｆａｎｇ ｃｈｕａｎ ｓｈｕｏ	色情
可愛均整清純派美女可愛均整清純派美女	色情
巨乳素人	色情
鸡巴蜜穴高潮	色情
遊戲嚮導	色情
batard	色情
骚屄儿	色情
我考	色情
你二大爺	色情
奇淫的老板娘	色情
手伸到两腿间	色情
龟头压挤阴道	色情
欧洲极品性交图片	色情
錯那嗎逼	色情
成人电影免费成人电影	色情
贺龙	色情
成人色站	色情
他馬的	色情
陰囊	色情
邓笑贫	色情
中央政治局	色情
毛摇头玩	色情
美女电影	色情
妹妹┅┅爽快┅┅死了	色情
大字报	色情
feng yun	色情
肥穴自拍	色情
扒开她两扇阴唇	色情
姊姊的小骚屄	色情
數碼精靈	色情
张伯笠	色情
┨	色情
陈蒙	色情
淫穴自拍	色情
成人免费影院	色情
天天干贴图	色情
ｓｈｅｎ ｚｈｏｕ ｔｉａｎ ｇｅ	色情
几八	色情
花心大型色站	色情
释欲	色情
ｊｉａｏ ｃｈｕｎ	色情
抽插小穴	色情
天安门英雄纪念碑	色情
成人导航X色成人导航	色情
多维社	色情
明星裸体写真图 meinv网络视讯三点	色情
毛他马的	色情
支持達賴	色情
胡錦涛	色情
导弹	色情
姣西	色情
极品奶妹	色情
guang zhi guo du	色情
溫逼	色情
歐美圖區	色情
免费试看激情成人电影	色情
淫液流入穴	色情
張 志 清	色情
教你怎样延迟射精34岁以下禁免费淫电影a片	色情
傷亡	色情
毛胡锦涛	色情
淫語痴女	色情
华语世界论坛	色情
人民大會堂	色情
无尽的任务	色情
疯狂jiejie教弟弟小说	色情
傅全有	色情
抵制	色情
免费午夜激情视频	色情
汽车爆炸案	色情
潘金莲全传	色情
淫色贴图小说	色情
干您娘	色情
教師禁斷接吻	色情
令人喷血的春宫108姿势(组图)20岁禁看	色情
奸淫电车	色情
陰道	色情
桑国卫	色情
斷水	色情
偷拍美穴	色情
顾顺章	色情
色网阴道特写强奸29岁处女全过程	色情
ｆｕｃｋ	色情
淫靡	色情
pusium pusium	色情
口內爆射	色情
大鸡巴干妹妹	色情
叛國	色情
克林顿	色情
meinv孩含双棍玩内射	色情
46xp。com 电影免费	色情
bt淫色电影免费下载	色情
挺动阿姨雪白肥臂	色情
我咧干	色情
萨达姆	色情
亚洲激情淫色贴图区	色情
%共產黨爛逼	色情
免费淫电影网址	色情
毛乳头	色情
毛分裂祖国	色情
色情电影免费看	色情
hero108	色情
鸡巴暴胀	色情
淫河	色情
淫蕩少婦好色老師	色情
项小吉	色情
日本成人激情	色情
曰GM	色情
流蜜汁	色情
那娘瘟比	色情
黄孟复	色情
可爱双胞胎美幼少女的性趣［亚无］［402mb］	色情
垃圾游戏	色情
你妈了妹	色情
Mai骚	色情
日你爷爷	色情
大波波	色情
錢 其 琛	色情
肉棒插入肉	色情
免费淫奸女Ａ片段试看 少妇扒开阴道图-淫賤少女阴唇特写图	色情
法~论	色情
湿润的嫩穴中	色情
鰢	色情
fofg	色情
操小穴	色情
温柔女孩操屄竟如此陶醉	色情
鸡巴淫沟插B大图	色情
姫辱	色情
教你怎样延迟射精24岁以下禁免费淫电影a片	色情
毛耶和华	色情
jiejie的阴唇好大啊	色情
成人 激情 淫 另类	色情
香港马会	色情
奸暴	色情
賣比	色情
李 總 統	色情
大肉棒干进小穴	色情
偷电	色情
表舅妈与我	色情
淫驢屯	色情
淫奸教师论坛	色情
大卵泡	色情
淫妹妹贴图	色情
美少妇的哀羞	色情
张晓丞	色情
快乐av	色情
剑网	色情
血洒	色情
亂倫熟女	色情
肏我的小屄	色情
緊縛淩辱	色情
罗干	色情
淫女吃尿	色情
店長推薦最新強片Sky Angel Vol。43最新強片	色情
KEFU	色情
强奸44岁处女全过程/淫妹阴毛小穴	色情
jiangdongriji	色情
免费淫电影，免费淫色情电影	色情
亞洲淫娃	色情
毛劳+教+所	色情
joyxy	色情
毛吕秀莲	色情
乳頭	色情
(Nadeshiko)夢の超高級癒し系Wおでかけソープ嬢 完全版	色情
騾幹	色情
玉蒲团玉女心经	色情
拉案)	色情
成人色情网站初中女生偷拍	色情
青 天 白 日 旗	色情
银民吧	色情
怀念十五年前的大学生	色情
鎮壓	色情
中国社会进步党	色情
紧缚凌辱	色情
国产骚货	色情
发^^论	色情
教你怎样延迟射精33岁以下禁免费淫电影a片	色情
清华网管	色情
新光明	色情
毛妓女	色情
日本风骚女电影	色情
人妻色诱	色情
ボディフェティッシュ　桜子 DVDISO	色情
毛监管局	色情
新西游记	色情
如果你未满32周岁请自觉离开。	色情
操射	色情
毛抗日	色情
肉缝　小肉穴	色情
无码做爱	色情
反革命暴乱	色情
熱血傳奇	色情
mo你全身	色情
高級逼	色情
香港免费淫电影	色情
姐姐被轮奸	色情
干GM	色情
發^^綸	色情
苯甲酰甲荃芽子堿	色情
干洋妞穴	色情
精液射入花心	色情
大哥 等等 我尿完后 再给你干肉穴	色情
冊那娘餓比	色情
乳此动人	色情
遺言	色情
客报	色情
蒋树声	色情
淫民激情文学图库	色情
体育练习场盗撮スポーツジム(4カメ洋式)	色情
功法	色情
廢墟	色情
江贼	色情
你色吗	色情
97sese	色情
布什	色情
F。L。G	色情
点击这里试看美女做爱现场	色情
小比样	色情
茎	色情
超级诱人销魂表情免费播放变身辣妹 插入妈妈白嫩的诱惑	色情
毛铁道部	色情
法~綸	色情
妓女靠	色情
transsexuel	色情
插入媽媽…肉缝	色情
毛叫鸡	色情
性爱频道	色情
毛吗啡片	色情
和两勇男玩40P	色情
95bb成人小电影	色情
斧頭鐮刀	色情
毛金正日	色情
胡锦滔	色情
fuck我操	色情
17岁处女小阴唇张开 淫水流出图强奸免费淫电影	色情
激情聊天室	色情
牛鬼蛇神	色情
淫样	色情
客服人員	色情
ｔｔｍｄ	色情
陰	色情
大肉茎插进小肉洞	色情
欣赏7感俏護士和医生22潮淫水图	色情
儿子的肉棒好长啊	色情
素人初撮り生中出し 观月雏乃	色情
白虎少妇	色情
枪决现场	色情
琼浆玉液	色情
台湾十八两性电影	色情
SM插进湿润的小穴	色情
毛死gd	色情
傅作義	色情
龟头挤进了紧窄湿润小嫩穴	色情
灭绝罪	色情
淫奸阿姨论坛	色情
肉棒　高潮	色情
j8靠	色情
虎虎虎~变态心Tora Tora Gold Vol。17 : Mako Takeda	色情
操草妈	色情
龟头顶破了处女膜	色情
极品波霸	色情
撅起大白腚	色情
裸体小姐作爱视频彩福联盟社区 大奶妹脱	色情
毛法制办	色情
幹妳老母	色情
可卡因	色情
┳	色情
tranny	色情
又肥又嫩的阴户	色情
毛鸟你	色情
八九事件	色情
现代情色小说	色情
天葬	色情
史玉柱	色情
kai xuan	色情
┖	色情
馬萬祺	色情
护士小穴 空姐小穴	色情
meinv含双棍玩内射	色情
免费电影 成人电影 激情电影	色情
小穴流淫水	色情
未满20岁的请自行离开 ！	色情
鸡巴对准穴口猛地插进去	色情
法~伦	色情
色网阴道特写强奸23岁处女全过程	色情
女良	色情
教室里淫乱狂搞	色情
乳爆	色情
干出淫水	色情
淫美贴图区	色情
仙界傳	色情
宁王府导航	色情
玉女心经	色情
肉棒刺入我的小穴	色情
圣战	色情
糾察員	色情
鸡巴插入肉洞	色情
肉棒触碰前面的肉穴	色情
分开两片肥嫩的阴唇	色情
５街区	色情
哲民	色情
李 总 理	色情
反中游行	色情
狗b	色情
街头篮球	色情
点击这里试看meinv做爱现场	色情
台湾ye77	色情
日韩淫乱美女图	色情
cS	色情
本站10020多部激情电影全部免费试看	色情
毛抢劫	色情
操她	色情
VIP独占~秘密之大乱交(最终话)	色情
遊戲新幹線	色情
賤B	色情
苏晓康	色情
东社	色情
魔法飞球	色情
毛日GM	色情
毛法愣	色情
幹你媽	色情
风水	色情
嫩鲍鱼	色情
淫水絲襪	色情
是鸡	色情
肉棒狂插 浪穴 嫩穴	色情
凤舞天骄	色情
免注册淫电影	色情
肉棒弄得湿溜溜的	色情
官方工作員	色情
操淫荡少妇 操淫荡妹妹 操淫荡姐姐 操淫荡护士 操淫荡 空姐操 老师操女老师 学生操老师 操老师小说	色情
亚洲激情网	色情
屄屄特寫	色情
妓院	色情
草你	色情
嫩缝	色情
强奸meinv狂插处女阴道	色情
情報	色情
陆定一	色情
不玩了靠	色情
现代学生妹操屄水平真是高	色情
operator	色情
严家其	色情
zhengjian皮条	色情
继母的爱液	色情
meinv性生活贴图	色情
ｄａ ｈｕａ ｃｈｕｎ ｑｉｕ	色情
売春婦	色情
哪有a片 百万美女贴图夫妻激情免费视频	色情
任你淫	色情
李洪	色情
曾道人	色情
色鬼	色情
ｍｉ ｚｈｕａｎ	色情
毛肉洞	色情
淫浪	色情
法伦功	色情
李登柱	色情
阳萎	色情
人妻色誘	色情
發@@倫	色情
內射美婦	色情
毛伊朗	色情
天之煉獄	色情
亚洲激情淫色网站	色情
老公，他要插进来了	色情
┫	色情
黄色激情电影	色情
流星学院	色情
发*轮	色情
色影院	色情
射屏	色情
大会堂	色情
法$沦	色情
媽的騷穴被你插得爽死了	色情
21cn	色情
宋慶齡	色情
淫の方程式	色情
三K党	色情
罗礼诗	色情
傅鹏	色情
免费观看王小丫做爱	色情
昏药	色情
淫水嫩穴	色情
san guo qun ying zhuan	色情
发^论	色情
集体淫	色情
牛B靠	色情
不要注册激情免费电影	色情
台湾淫电影 导航	色情
chinaliberal	色情
破坏	色情
放蕩少婦	色情
发$纶	色情
街头对抗	色情
大鸡巴 插 少妇	色情
免费成人激情视频聊天	色情
台湾18成人小说 免费成人电影	色情
┱	色情
ｌｏｖｅｂｏｘ	色情
fuck小穴	色情
毛狗日	色情
全国人大	色情
售号	色情
日本美女图库	色情
啊呀娃娃	色情
蔡和森	色情
激情潮噴	色情
儿子的肉棒好硬	色情
和两勇男玩12P	色情
不注册看艳片	色情
吊子	色情
毛发改委	色情
毛耶苏	色情
tmd	色情
PUSSY	色情
发$$仑	色情
毛你姥	色情
粉嫩粉嫩的小穴	色情
鹿城娱乐	色情
含屌	色情
不爽不要錢	色情
┕	色情
rxwg	色情
虎騎	色情
粉红嫩穴 鲍鱼嫩穴=1	色情
啊无卵	色情
四我周	色情
木子论坛	色情
台湾成人激情视频聊天室	色情
童屹	色情
操女人穴	色情
成人电影 淫穴嫩穴骚穴	色情
connard	色情
GY	色情
法@@仑	色情
bong	色情
可愛虎牙學生妹	色情
死GM	色情
伸入姐姐裙内	色情
董必武	色情
Red Hot Fetish Collection Vol。30 森田めぐみ	色情
争鸣论坛	色情
共狗	色情
毛短信群发器	色情
voachinese	色情
阿扁萬歲	色情
性娱情色导航	色情
世模	色情
家乐福	色情
百家性超级淫色图片	色情
絲襪寫真	色情
免注册台湾18dy	色情
開苞	色情
激情影片网站	色情
法*沦	色情
成人激情午夜场	色情
干小姐小穴	色情
妈	色情
事屎	色情
用手指挖她的小穴，弄得她娇喘连连	色情
fuck死GD	色情
fuck石进	色情
日本淫图	色情
恐怖分子	色情
用他的舌尖舔着我的乳头	色情
娘個比	色情
無碼電影	色情
第七色明星淫欲	色情
┤	色情
龜奴	色情
脚交	色情
fuck色情服务	色情
倡议书	色情
温暖湿润的感觉笼罩龟头周围	色情
毛国研室	色情
於永波	色情
日本meinv吃精图	色情
毛鸠	色情
鸡掰	色情
裸体meimei林心如穴	色情
免费A片观看	色情
Image)ヌーディストGALビーチ	色情
淫奸少女贴图淫奸女护士贴图淫暴亚洲	色情
又粗又长的大肉棒	色情
看牌軟體	色情
扎卡维是英雄	色情
ｃｒｏｎｏｕｓ	色情
肉棒插护士穴骚穴	色情
奇域	色情
小電影	色情
三角裤	色情
可爱卡通小穴	色情
耶穌	色情
多党执政	色情
暴行白書女	色情
地震局	色情
毛侨办	色情
teen	色情
淫影院论坛	色情
压制	色情
免费在线淫电影	色情
(SOD)芸能人 範田紗の超高級ソープ嬢	色情
meimei的阴道好嫩啊	色情
64动乱	色情
毛胡XX	色情
ｔｎｎｄ	色情
高潮白浆	色情
肉棒插入风骚少妇穴	色情
女老板一丝不挂躺在我身边	色情
SHIT	色情
淫糜	色情
毛以茎至洞	色情
fuck希望之声	色情
弟弟的肉棒好长啊	色情
服務管理	色情
RI NI MA	色情
吗啡	色情
毛台湾党	色情
爽	色情
fgmtv	色情
mao xian dao	色情
di guo chuan qi	色情
超級可愛巨乳妹被狂插得鼻血滿天飛	色情
犯践	色情
淫水四濺	色情
江泽民	色情
…你的鸡巴 用力干	色情
天皇	色情
網管	色情
欧美激情淫色贴图	色情
教你怎样延迟射精39岁以下禁免费淫电影a片	色情
法轮功	色情
东京热5月新片	色情
爽女美图美搜性感图涩界成人电影网小小鸟绝色meinv写真图	色情
肛屄	色情
ｇａｍｅ　ｍａｓｔｅｒ	色情
未成年人禁入	色情
魔幣	色情
如果你未满19周岁请自觉离开。	色情
极品成人A片无码	色情
处女心经	色情
母子淫奸乱轮现场看，瞄準她的肉穴插了進去……	色情
发廊	色情
大 纪 元	色情
二逼	色情
見到這個美女就會有性欲	色情
毛客户服务人员	色情
学生与警察	色情
瘋狂賽車	色情
正见网	色情
迪里夏提	色情
毛阴茎	色情
淫欲日本	色情
媽媽的	色情
法@掄	色情
西藏天葬	色情
新闻出版	色情
ｓｈａｏ ｌｉｎ ｃｈｕａｎ ｑｉ	色情
yuming	色情
曲線消魂	色情
彭德懷	色情
又大又嫩的屄	色情
倪育贤	色情
裝備演示	色情
舔 b	色情
爽女美图美搜性感图涩界成人电影网小小鸟绝色美女写真图	色情
捐赠排行	色情
天安门残案	色情
FLG	色情
浓浓的精液喷入了子宫	色情
成人色网站	色情
刘正荣	色情
肉淫器吞精	色情
peacehall	色情
少妇房中自淫，和两勇男玩5P，操得直叫爽 操日本淫女穴	色情
玉蒲团讯雷下载	色情
秦基伟	色情
李登輝	色情
ｇｙ	色情
富兰克林	色情
三去车仑功	色情
和两勇男玩52P	色情
老师嫩穴 极品嫩穴 淫穴嫩穴	色情
林心如做爱网有激情自拍	色情
15年前的“共和國衛士”	色情
彭佩云	色情
美女 成人	色情
张志清	色情
娘饿比	色情
日本18淫电影网	色情
光線	色情
米青	色情
龜公	色情
张立昌	色情
冰毒	色情
发$$沦	色情
逼样	色情
LIUSI	色情
地 下 教 會	色情
走光偷拍	色情
89-64cdjp	色情
爛	色情
車侖	色情
激情淫穴的嫂嫂	色情
cao ni ma	色情
何候华	色情
江八条	色情
明星合成图	色情
嗑药	色情
性色社区	色情
图片不爽你砍我	色情
法$论	色情
ｓｈｅｎｇ ｄａ ｆｕ ｗｅｎｇ	色情
專制	色情
prostituta	色情
多维周刊	色情
金庸群俠傳	色情
Chink Chink	色情
政治局常委	色情
钢甲洪流	色情
裸聊合法	色情
和两勇男玩44P	色情
fuck新华社	色情
台湾成人18贴图	色情
强奸 小穴	色情
轩辕剑	色情
激情小电影	色情
气性壞疽病	色情
免注册在线淫电影	色情
游戏橘子	色情
懆您妈	色情
滕任	色情
又深又紧的穴	色情
手记注册日韩5004部激情电影	色情
搞你	色情
黄色免费电影淫电影在快要射精时迅速地将	色情
你马的	色情
女秘书做爱吞精图	色情
二五互聯	色情
廉政大论坛	色情
浪叫	色情
肥逼	色情
淫骚穴电影	色情
国内动态清样	色情
回教	色情
鲍戈	色情
周鉄農	色情
色猪猪成人导航	色情
淫妻的亂交免费在线看	色情
rong yao	色情
逼癢	色情
肏meimei淫屄	色情
远志明	色情
毛破坏	色情
他奶奶的	色情
造反	色情
mei li shi jie	色情
一面做愛	色情
QQ堂	色情
a4y	色情
ｋｊｋｉｎｇ	色情
水扁	色情
斯蒂芬	色情
毛驶你母	色情
圓滿	色情
办公室性欲	色情
mannweib	色情
色情	色情
11月更新成人导航	色情
免费淫电影	色情
大麻	色情
Clayton Dodge Clayton Dodge	色情
xiao77	色情
SM处女淫水图	色情
恐怖主义	色情
62xp。com 电影免费	色情
抽插34岁处女妹妹淫叫不断	色情
她的阴道好紧啊	色情
抽插43岁处女meimei淫叫不断	色情
六四死難者	色情
玉穴	色情
滚那吗瘟比	色情
毛特别公告	色情
日本淫乱漫画图片 欧美母子淫乱图片	色情
江泽慧	色情
激情聊天	色情
fuck新生网	色情
苯比	色情
ｘｉｎ ｘｉ ｙｏｕ ｊｉ	色情
春色满园淫妻系列	色情
阿里布达年代记	色情
色网导航	色情
成人性交视频	色情
9v9e	色情
恐怖份子	色情
狂插妹妹穴	色情
宁王府淫图导航	色情
肉具	色情
公媳亂	色情
肥穴姐姐	色情
运营	色情
fuck新闻办	色情
暴奸	色情
f r e e c h i n a	色情
蒋彦永	色情
强　奸	色情
rivals	色情
黄色电影	色情
江湖淫娘	色情
陰門	色情
色情小电影	色情
骚屄	色情
陈至立	色情
JB	色情
q币	色情
毛江独裁	色情
我和姐姐的淫乱史	色情
肏肉~X屄爽歪歪	色情
江绵恒	色情
工商局	色情
毛南联盟	色情
赛妳娘	色情
骑你	色情
小参考	色情
homosexuell	色情
吃大便	色情
放荡少妇宾馆	色情
A片	色情
插小穴射了	色情
游行	色情
嫂子的阴道好大啊	色情
把肉茎舔乾净	色情
氢弹	色情
Mysupersales	色情
foseaon	色情
发仑	色情
劉伯承	色情
露陰照	色情
裸体做爱	色情
┘	色情
明星裸体写真图 美女网络视讯三点	色情
抽插28岁处女meimei淫叫不断	色情
damn	色情
安全局	色情
色魔	色情
中國豬	色情
ｐｏｐｋａｒｔ	色情
猪毛1	色情
cao靠	色情
刚瘪三	色情
熟女乱伦网	色情
方晓日	色情
淫奸处女电影	色情
周天法	色情
抽	色情
插烂她的小屄	色情
未亡人柔肌	色情
買幣	色情
公媳性交淫荡图片	色情
在线清晰日本超爽mm毛	色情
操陈水扁	色情
毛燕玲论坛	色情
淫女贴图区	色情
蒋彦勇	色情
性感动感meinv日本幼少女性感写真	色情
他妈ㄉ王八蛋	色情
毛华建敏	色情
恼杀美巨乳meinv~吉川萌	色情
连线机	色情
插屁眼	色情
做爱网有激情自拍裸体	色情
我日你妈	色情
激情自拍小电影	色情
www。zqrl。com	色情
坤迈	色情
成人淫伦	色情
姐弟淫穴小说	色情
re xue ying hao	色情
农村人乱伦事	色情
毛杀人犯	色情
操宾周	色情
操你大爷	色情
告全體線民書	色情
性交电影	色情
免费聊天室	色情
温b	色情
比卵	色情
ｓｉｌｋｒｏａｄ	色情
小泉彩~黑人体内射精连续20发	色情
鸡巴插入花心	色情
大胆少女	色情
老逼	色情
美国参考	色情
毛烂比	色情
淫奸女教师	色情
淫电影//令人喷血的春宫108姿势	色情
剃毛	色情
磨蹭阴道阴毛	色情
然后	色情
02jam	色情
淫水 …你的大肉棒	色情
白嫩meinv穴	色情
强奸33岁处女全过程/淫妹阴毛小穴	色情
boxun	色情
炮打中宣部	色情
精液喷射在子宫上	色情
骚穴	色情
预审查	色情
强奸35岁处女全过程/淫妹阴毛小穴	色情
毛十五周年	色情
服务管理	色情
ｐａｏ ｐａｏ ｔａｎｇ	色情
教你怎样延迟射精19岁以下禁免费淫电影a片	色情
子女任职名单	色情
瘸腿帮	色情
龟奴	色情
玉蒲團	色情
ｓｈｕ ｍａ ｊｉｎｇ ｌｉｎｇ	色情
叛党	色情
西哈努克	色情
破处	色情
匯款	色情
少妇房中自淫，和两勇男玩17P，操得直叫爽 操日本淫女穴	色情
阴壁肌肉紧紧挤压着棒鸡巴	色情
meinv下体淫水直流	色情
柯慶施	色情
和meimei肏屄	色情
moyu	色情
三国豪侠传	色情
免费淫电影a片	色情
洪传	色情
激情淫片	色情
歐美無套	色情
色情工廠	色情
苯環已哌啶	色情
援交自拍	色情
在线淫洞影院	色情
露点	色情
98bb	色情
毛希特勒	色情
歇逼	色情
65情网色论坛色情电影	色情
二穴中出	色情
赛她娘	色情
鬼公	色情
干你妈	色情
流口水啦	色情
她NND	色情
鬼畜輪奸	色情
发~~沦	色情
淫乱诊所	色情
黑鲍娇	色情
張梅穎	色情
游戏管理员1	色情
淫奸处女	色情
是雞	色情
肉棒……插死浪穴了	色情
淫驴屯	色情
免费淫奸女Ａ片段试看 瞄準她的肉穴插了進去……	色情
淫荡┅插 小穴	色情
毛乔石	色情
成人 激情 淫乱 另类 高潮	色情
毛干gm	色情
狹義道	色情
幼齿	色情
怎样延迟射精18岁以下禁	色情
毛肉穴	色情
毛十年动乱	色情
淫穴影院	色情
装逼呢	色情
dick	色情
监听王	色情
婷婷成人激情淫洞	色情
剛比樣子	色情
操我	色情
法~~伦	色情
础	色情
插你爸	色情
25dy淫色贴图	色情
毛贱	色情
东北风情熟女之惑	色情
新华通论坛	色情
受灾	色情
caoB	色情
賞圖交流園	色情
巨乳俏女医	色情
阴茎在我阴道里急速抽送	色情
屄……爽死……了……嗯……嗯……快……快	色情
幹你老比	色情
燕玲论坛	色情
免费淫奸女Ａ片段试看 教你怎样延迟射精18岁以下禁	色情
鹿城激情淫色贴图	色情
胡錦淘	色情
44lian色站大全	色情
钟山风雨论坛	色情
发~~抡	色情
注册通道看情色电影	色情
大鸡吧顶进小穴	色情
身份证生成	色情
啊雅娃娃	色情
鬼村	色情
騷批	色情
GAN	色情
黄慈萍	色情
蕩妹	色情
亚洲激情淫穴	色情
共匪	色情
我奸	色情
renmingbao	色情
倫功	色情
鹿城黄站小说	色情
亚洲成人激情影院	色情
林伯渠	色情
呂秀蓮	色情
免费meimei黄色淫乱	色情
Red Hot Fetish 纹舞らん--スケパン刑事	色情
男人看的猛爽电影	色情
娘比	色情
fy0	色情
人民報	色情
胯下呻吟	色情
儿子顶到妈妈的花心	色情
Shit Shit	色情
獨占動畫~肛門 1~長谷川	色情
本站10001多部激情电影全部免费试看	色情
中国共产党	色情
毛恐怖份子	色情
无修正	色情
馬場大亨	色情
無需刷卡	色情
爽死你淫图	色情
法錀功	色情
抽插56岁处女meimei淫叫不断	色情
枪淫少妇	色情
泽民	色情
鸡吧在肉洞里四处搅动	色情
MAKELOVE	色情
旅游局	色情
桑國衛	色情
日本成人电影 性生活影片 免费在线成人电影	色情
亂倫之公公與兒媳的秘密	色情
美女吞精	色情
监管局	色情
操护士	色情
幸福花園	色情
混乱冒险	色情
应召	色情
g8	色情
淫戰群P	色情
激情打炮	色情
毛淫娃	色情
毛佛教	色情
优质美少女	色情
逼痒	色情
zhuanfalun	色情
系统公告	色情
Tsubaki House-Triple Shot Vol01校花三姐妹	色情
透視軟體	色情
韩日成人激情电影	色情
制服狩	色情
操春药	色情
淫穴把整个龟头吸住	色情
51yxb	色情
ｘｉｎｇ ｚｈａｎ ｑｉｎｇ ｙｕａｎ	色情
jiejie的阴道好紧啊	色情
jiejie和我乱伦理电影	色情
淫奸mm电影	色情
１９８９ 天安門	色情
K他命	色情
耿飚	色情
毛届中央政治局委员	色情
操淫荡少妇 操淫荡妹妹	色情
江独裁	色情
淫乱姐姐小说	色情
骆 冰 淫 传	色情
騷婦露逼	色情
騷棍	色情
法~~仑	色情
侖功	色情
反华	色情
天安门一代	色情
浴室亂倫	色情
管理員	色情
大鸡巴顶进meimei的花心	色情
流淫水	色情
中華民國	色情
買賣	色情
骚妈	色情
ora-Tora Gold Vol。4~~ささきふう香~~92cm G罩杯美爆乳	色情
遇难	色情
淫乱	色情
dick吕秀莲	色情
吸精痴女	色情
fuck杀人犯	色情
大鸡巴┅┅太棒了	色情
乳此丰满	色情
法輪大法	色情
你操得我更爽	色情
毛吴　仪	色情
51淫色导航	色情
ｐｌａｎｅｔｓｉｄｅ	色情
暴操淫荡小妹妹	色情
穴海	色情
战国英雄	色情
毛玉杵	色情
meinv偷拍成人小说激情网	色情
33bbb走光	色情
毛手淫	色情
她爸爸	色情
插着淫穴	色情
peng peng bang	色情
乳峰	色情
司马晋	色情
一起玩游戏网	色情
7。22	色情
插你	色情
毛澤东	色情
淫色电影免费在线观看	色情
日九城	色情
学生妹meinv在野外偷情	色情
镇压学生	色情
夏夏娱乐黄站 乱伦熟女网	色情
弟大物勃	色情
欧美大乳	色情
香港激情图源成人色情论坛脱衣meinv做愛	色情
爛比	色情
獨	色情
大鸡吧插meimei	色情
羅富和	色情
你以为你装逼就能骗我	色情
台湾电影网龙游龙洲影院日本娱乐性免费电影在线	色情
十八代	色情
肉棒插入肉穴	色情
至淫绝地	色情
B博士	色情
dyonline	色情
档案局	色情
汪岷	色情
毛驶你老母	色情
本	色情
杨怀安	色情
16dy-图库	色情
不斷收緊陰道來吞噬我的龟头	色情
ＦＵＣＫ	色情
吹箫	色情
法伦	色情
扒开淫女的骚逼	色情
淫奸小电影	色情
顶到花蕊	色情
骡干	色情
jinku	色情
男女激情淫贴图	色情
luan shi san guo	色情
法仑共	色情
ｓｈｅｎ ｊｉａ ｑｉ ｂｉｎｇ	色情
华国锋	色情
世界经济导报	色情
首長	色情
抽插49岁处女妹妹淫叫不断	色情
插的妈妈的小穴好爽	色情
日本meimei	色情
江擇民	色情
fuck他祖宗	色情
鹿城色妹妹大型黄站	色情
人民币	色情
东京热 n0151 工藤裕子 美丽子宫大精液轮奸教室	色情
暗黑之门	色情
免费在线收看淫色电影	色情
媽個比	色情
阿姨的小穴	色情
法@仑	色情
视频聊天导航	色情
ｑｑｔａｎｇ	色情
好紧的阴户	色情
毛莫索里尼	色情
精液射在meimei的子宮	色情
鸡吧插到嫩穴	色情
淫荡jiejie勾引小弟玩操屄	色情
穷b	色情
白液四溅	色情
天縱	色情
孔雀王	色情
voa	色情
U  R靠	色情
毛六四事件	色情
東熱空姐	色情
西藏事件	色情
毛舆论钳制	色情
麦叫酸	色情
可视视频聊天	色情
ASS	色情
手记注册日韩5024部激情电影	色情
親日	色情
它妈地	色情
民国	色情
毛睾	色情
免费视频激情聊天室	色情
性爱电影网	色情
山不过来	色情
中青旅创格	色情
聯 總	色情
大麻油	色情
口爆	色情
免费激情论坛	色情
SM	色情
傻B江核心	色情
宾周	色情
乳尖	色情
淫色bb贴图	色情
逃亡艳旅	色情
台湾国	色情
你是鸡	色情
大鸡巴紧紧的插穴	色情
鲁迅	色情
太監	色情
操黑	色情
午夜成人场	色情
6。4	色情
毛切七	色情
蒙哥马利	色情
金三角	色情
大众真人真事	色情
肉棒插进她的密洞使劲的抽送着	色情
董贱华	色情
無毛美少女	色情
文化部	色情
韩东方	色情
meimei的阴唇好嫩啊	色情
meimei张开双腿等你操	色情
妳马的	色情
电影下载	色情
熟女颜射	色情
射了還說要	色情
机叭	色情
骚浪人妻	色情
去你媽的	色情
反攻大陸	色情
移彩聯合	色情
兔meimei色色贴图区	色情
姐姐的嫩阴唇	色情
援助交際	色情
毛一国两制	色情
達賴	色情
和两勇男玩9P	色情
毛严方军	色情
騷水	色情
ＧＡＭＥ　ｍａｓｔｅｒ	色情
抢粮记	色情
ａｒｃｈｌｏｒｄ	色情
卖号靠	色情
豖者	色情
胡錦滔	色情
哦……你插的好深啊……又顶到我的子宫……啊	色情
淫妻浪女小说	色情
毛吴仪	色情
下载淫电影	色情
毛黄菊	色情
穆斯林	色情
情獸	色情
新大陆	色情
血洗	色情
jie tou lan qiu	色情
胡錦濤	色情
操大波波	色情
军火价格	色情
系统讯息	色情
圣泉学淫	色情
劉曉波	色情
bukkake	色情
女儿淫奸妈妈穴	色情
上有网	色情
济南建设路	色情
插如妈妈肉穴	色情
強姦物語 逢乃	色情
戈万钧	色情
165网址宽频影院网	色情
耶和華	色情
聖泉學淫	色情
百戰天蟲	色情
毛禁书	色情
帝國傳奇	色情
情色电影	色情
神經病	色情
艷舞淫業	色情
我和小啊姨在车上做	色情
毛去你妈的	色情
tie jia zheng xiong	色情
發掄功	色情
52淫色导航	色情
騷逼	色情
摳穴	色情
淫荡女护士 淫荡少妇穴	色情
发~~纶	色情
亚洲成人激情淫影院	色情
灌滿精液	色情
完全免费电影在线看	色情
美腿	色情
点点激情播放性电影	色情
阴道抽搐一阵暖流自子宫深处涌向龟头	色情
台湾民國	色情
漢 奸	色情
淫色少妇狗小说大全	色情
我和二姨在车上舔	色情
fuck尉健行	色情
电影小片段试看免费淫影片	色情
蓬浪	色情
遊戲橘子	色情
成人午夜激情视频聊天室	色情
激爽电影VIP会员注册区	色情
ｂａｓｔａｒｄ	色情
毛二B	色情
翹臀嫩逼	色情
错比	色情
fuck我操你	色情
龟头	色情
操大逼	色情
妈妈	色情
激情淫穴小少妇	色情
免费淫奸女护士图片	色情
玉蒲团	色情
朱嘉明	色情
草芝麻	色情
信长之野望	色情
哈批	色情
那可汀	色情
大話西遊	色情
变态小日本街头强制脱衣最新加强版多片	色情
测试员	色情
教你怎样延迟射精35岁以下禁免费淫电影a片	色情
少妇床上欲火难耐自mo图	色情
乱伦(无码)母爱包( 乳母	色情
女教师淫乱课堂	色情
居家女人的淫荡性事	色情
傅作义	色情
外交部	色情
fuck他母亲	色情
淫荡	色情
毛新光明	色情
古龙	色情
智障	色情
华夏II Online	色情
毛狂操你全家	色情
狂插处女穴 淫水流	色情
meimei淫水 流	色情
免费淫奸女Ａ片段试看 强*十八岁meinv护士	色情
賽你老母	色情
ｌｉａｎ ａｉ ｈｅ ｚｉ	色情
orgasmus	色情
Gold Angel Vol。8 Super Erotic Girl : Rio Nakamura 仲村りお	色情
日本淫贴图 淫妻贴图	色情
操陈至立	色情
鸡巴插入蜜穴	色情
小穴插的紧紧	色情
欧美两性淫乱图片	色情
淫獣圣戦 XX+圣獣伝 ツインドールズ	色情
ｒａｐｅ	色情
法$$仑	色情
无码精选	色情
魔法奇兵	色情
┞	色情
乔冠华	色情
黃　菊	色情
臺獨	色情
發浪	色情
桃色电影	色情
懆您娘	色情
傻屄	色情
公告消息	色情
骆冰淫传	色情
紅衛兵	色情
穴居人淫色贴图	色情
毛董贱华	色情
口交靠	色情
免费成人午夜电影	色情
柔软红嫩的小阴唇紧紧地护住她的阴道口	色情
成人百强	色情
高校群体事件	色情
麻醉钢枪	色情
亚洲激情淫色网址	色情
聯眾	色情
福爾摩薩	色情
发**纶	色情
毛卖ID	色情
光之國度	色情
教你怎样延迟射精18岁以下禁	色情
禽兽集团%少儿禁	色情
激情淫	色情
搔妹妹色站大全	色情
淫水自乐	色情
幼穴贴图 毛穴贴图 穴淫贴图	色情
驶你爸	色情
毛性欲	色情
Rape	色情
毛meimei贴图区	色情
藏独	色情
暴幹	色情
merde	色情
北川	色情
手记注册日韩5002部激情电影	色情
咪咪色界	色情
高清晰无码内射	色情
closeupsof。us	色情
幹炮	色情
抽插24岁处女妹妹淫叫不断	色情
黃易群俠傳	色情
强奸17岁处女全过程/淫妹阴毛小穴	色情
砍死你	色情
毛阴户	色情
少妇房中自淫，和两勇男玩18P，操得直叫爽 操日本淫女穴	色情
ａｉｏｎ	色情
姐的嫩阴道	色情
淫色释放贴图	色情
jiejie的小穴	色情
破鞋	色情
日韩meimei嫩穴淫图	色情
超爽艳图	色情
淫乱熟女	色情
彩虹骑士	色情
李鐵映	色情
巨乳俏女醫	色情
游戏管理者	色情
牛B	色情
我干	色情
骚母	色情
高清性愛	色情
出售手枪	色情
qi xia	色情
奥美电子	色情
阴阜	色情
两国论	色情
团中央	色情
欣赏特级毛片pp 点点毛片 meinv毛片 大陆毛片	色情
免费在线成人电影	色情
一股淫液从肉洞喷出	色情
黑窑奴役	色情
淘宝靠	色情
法^論	色情
毛李鹏	色情
我与网吧老板娘	色情
性爱插穴	色情
大陆娱乐最新黄站	色情
Party	色情
美利坚	色情
放蕩熟女	色情
…好舒服 奸淫 操	色情
下作	色情
沙僧	色情
blueeye	色情
新疆打砸抢	色情
中功	色情
遺忘傳說	色情
megaone。com	色情
教你怎样延迟射精22岁以下禁免费淫电影a片	色情
达癞	色情
大奶騷女	色情
风雨神州	色情
激情MM	色情
好紧的阴道啊	色情
操爽	色情
我和老板娘	色情
本站绝无任何形式木马病毒	色情
比毛	色情
集会	色情
發^論	色情
fuck天安门事件	色情
官商勾结	色情
肏又大又嫩的屄儿	色情
脑残	色情
毛机八	色情
大鸡吧寸寸深入直顶她小屄的花心	色情
豔乳	色情
激情 少女 成人论坛 乱伦 强奸	色情
sex	色情
肉莖	色情
近亲相奸 背徳愉悦 9	色情
JOB	色情
压/无码	色情
红 色 恐 怖	色情
mysupersales	色情
163网址宽频影院网	色情
食屎	色情
gun gun qiu	色情
极景	色情
媚藥少年	色情
免费淫*女Ａ片段	色情
万钢	色情
毛贱货	色情
淫欲	色情
大血B	色情
冰锋	色情
凱圖科技	色情
登 辉	色情
强奸17岁少女全过程	色情
垃圾游戏靠	色情
三句硬话	色情
滾那嗎錯比	色情
沾满蜜水又湿又滑柔软的 阴唇	色情
做爱自拍	色情
萨马兰奇	色情
淫色小说网短片色情	色情
灌满精液	色情
盛宣鳴	色情
淫电影a片	色情
tiao zhan	色情
品色激情电影	色情
中宣部是中国的艾滋病	色情
狂插小穴	色情
自治机关	色情
aids	色情
fuck双峰微颤	色情
wg2222	色情
台湾狗	色情
姐弟激情淫秽	色情
江山	色情
淫奸meimei电影论坛	色情
ｄｉｃｋ	色情
2逼靠	色情
海盜王	色情
fuck台湾国	色情
賣騷	色情
幼交	色情
爱神之传奇	色情
肉棒插入小阴户内	色情
毛台湾狗	色情
沃尔开西	色情
李山	色情
龚学平	色情
毛看棋器	色情
干死客服	色情
辽宁女	色情
女醫師過度輪姦陰道麻痺+大量中出強制飲尿小便斗	色情
插嫩穴	色情
毛阴核	色情
本站10004多部激情电影全部免费试看三天	色情
含住肉棒上下使劲吸吮起来	色情
毛麻醉枪	色情
Reign Of Tera 2	色情
親 美	色情
插死你	色情
装备演示	色情
免费电影欧女乱欲	色情
性交图	色情
peachall	色情
荡妖艳女医生	色情
他马的	色情
免费淫 色电影	色情
大型色站	色情
淫妹	色情
吳 邦 國	色情
臭化西	色情
毛三唑仑	色情
人大代表大会	色情
快来┅┅插 肉穴	色情
(國產)視頻-网吧老板玩穴	色情
濕了還說不要	色情
64事件	色情
干bi	色情
插 11p	色情
毛激情小电影	色情
夏树唯	色情
剑侠世界	色情
强奸轮奸美女视频	色情
精蟲	色情
好紧的小穴	色情
毛监听王	色情
民联	色情
發@@論	色情
49xp。com 电影免费	色情
肉棒 插 穴	色情
龙图智库	色情
新手辅导员	色情
三P	色情
苏秀文	色情
中華人民共和国	色情
轻轻地抽动著阳具	色情
拉皮條	色情
政治协商会议	色情
豬容基	色情
阴道	色情
幼图	色情
香港激情片色情工厂直播香港彩福联盟激情	色情
耿飙	色情
大幅的陰毛覆蓋著她的迷人洞	色情
日本领事馆	色情
游戏送奖员	色情
毛食捻屎	色情
女教師赤版	色情
粉红嫩穴 鲍鱼嫩穴=3	色情
激情影视	色情
何候華	色情
幼女嫩穴	色情
她的阴户好嫩啊	色情
肏meimei屄	色情
操小姨子穴真爽	色情
肉棒 抽插 小穴	色情
东方传说online	色情
法惀功	色情
你是鸭	色情
毛社。会。正。义。力。量	色情
国产偷拍	色情
大B	色情
地富反坏右	色情
国外激情淫色贴图	色情
激情淫影片	色情
抽插小淫穴	色情
熱 站 政 論 網	色情
华岳时事论坛	色情
最新n0242 东热RQ大乱交2007 Part1	色情
情色成人	色情
喷你	色情
骚姐乱伦	色情
偷情男女	色情
灯草和尚	色情
龍圖智庫	色情
強制フェラ 失神セックス	色情
www。gpchina。net	色情
@sshole	色情
李洪宽	色情
聊齋艷譚	色情
你以为你装屄就能骗我	色情
鸡巴 淫穴	色情
fuck温家保	色情
毛洪兴	色情
扒穴	色情
365情色	色情
Mugen Vol。11 Ai Hazawa羽沢愛！【AVI/ 699MB】	色情
潘国平	色情
GameMaster	色情
毛系统讯息	色情
日本顶级淫片	色情
淫亂潮吹	色情
黎安友	色情
強姦媽媽…肉缝	色情
六四風波	色情
丰盈雪白的肌肤肥嫩饱满的乳房红晕鲜嫩的小奶头	色情
义解	色情
淫水爱液	色情
男男激情影院	色情
幾叭	色情
色女免费黄色小电影	色情
秘密調教凌辱	色情
情色天崖	色情
好爽┅好舒服小骚穴	色情
台湾岛国	色情
日批	色情
兼职女教师	色情
掰穴打洞	色情
成熟性感大meinv	色情
發~綸	色情
法西斯	色情
發$淪	色情
毛meimei淫色	色情
公务员	色情
黑手党	色情
死gm	色情
毛塞你娘	色情
makinglove	色情
抽插39岁处女妹妹淫叫不断	色情
svdc	色情
色情小说 BT限制级电影	色情
法~沦	色情
求救遭拒	色情
本站10014多部激情电影全部免费试看	色情
功	色情
天安门屠杀	色情
san guo hao xia zhuan	色情
好大阴户	色情
獲救	色情
生命奇跡	色情
免费淫电影吴宗宪搞笑语录(25禁看)	色情
轮操	色情
淫穴	色情
封从德	色情
激情淫咪咪贴图区	色情
ｔｉａｎ ｘｉａ ｅｒ	色情
Baopi	色情
愛滋	色情
地球文明	色情
毛华国锋	色情
zhongguohun	色情
狗屎	色情
激情视频	色情
蒙古鞑子	色情
教你如何延迟射精	色情
成人影院 激情影院	色情
不注册淫电影	色情
毛叶剑英	色情
ｆｅｉ ｃｈａｎｇ ｓａｎ ｇｕｏ	色情
史迪威	色情
轮奸	色情
毛小乳头	色情
裸女乳房阴道丰臀	色情
疯狂姐姐教弟弟小说	色情
毛国家主要部委	色情
懶叫	色情
操淫荡少妇	色情
圣者无敌	色情
漢娃娃	色情
肉棒插肉缝	色情
ｊｉｎｖ	色情
發**倫	色情
证监会	色情
视频脱衣秀亚洲少女韩国无码片	色情
麻黃素	色情
情色视频聊天	色情
贼民	色情
肉棒伸入她的口中	色情
射进女儿的屁眼里	色情
乳丰穴嫩激情性电影	色情
她馬的	色情
抽插53岁处女meimei淫叫不断	色情
朝鮮	色情
毛昏药	色情
黄蓉舔小龙女的乳头	色情
GM美国	色情
毛卖逼	色情
阴毛	色情
和两勇男玩22P	色情
滚那吗B	色情
李鹏*	色情
发^^抡	色情
ｃｈｅｎｇ ｊｉ ｓｉ ｈａｎ	色情
卡通动漫美女淫乱	色情
廁所偷拍	色情
观看淫电影 看完保证你打飞机	色情
日爽	色情
中央政府	色情
销魂洞	色情
欲女	色情
舔腳	色情
操你	色情
色淫成人	色情
Tibet独立	色情
陵辱面接4人淫乱娘	色情
干鸡	色情
少妇房中自淫，和两勇男玩12P，操得直叫爽 操日本淫女穴	色情
惊天动地	色情
成人激情导航	色情
天龍八部	色情
清纯派meinv可爱的让人想狂干她！【RMVB/195MB】	色情
免费Ａ片在线	色情
桃色	色情
东突组织	色情
干机	色情
日比	色情
来回去舐她的小穴	色情
美乳看護學生	色情
手记注册日韩5021部激情电影	色情
糞	色情
日啊	色情
政权	色情
少女床上春色销魂	色情
台湾分裂	色情
阿拉法特	色情
无码淫女	色情
cnd	色情
毛仆街	色情
韓正	色情
pcik	色情
艾森豪威尔	色情
四眼醫生強制飲尿 美巨乳小野悠美第二彈	色情
免费午夜电影	色情
igxe	色情
毛天安门事件	色情
女友下班后被别人献花接走给操了	色情
法^綸	色情
操mm嫩穴	色情
激情小說	色情
抵制日货	色情
姐弟激情淫色	色情
淫奸小姨淫水流	色情
陈炳基	色情
大话战国	色情
焚烧	色情
激情淫色文章论坛	色情
gan	色情
操XX	色情
扒开嫩穴	色情
煞逼	色情
爷爷顶到嫂子的花心	色情
成人 激情 性爱	色情
爱图公园论坛	色情
免费淫奸女Ａ片段试看 欢迎点击进入观看/林/心如/20岁处女偷拍/免费A。B片	色情
大清帝国	色情
毛奸	色情
浪穴被你插得爽死了	色情
入穴一遊	色情
和嫂嫂淫穴	色情
龟头在她的阴户里抽插	色情
法侖	色情
藏青社	色情
客服人员	色情
Tora Tora Gold Vol。18 : 冈田さな Sana Okada	色情
少妇自慰	色情
法^掄	色情
插进鲜嫩的小穴	色情
现代艳帝传奇	色情
商务部	色情
89动乱	色情
成人午夜	色情
你的 嫩穴 好粗	色情
猛插小护士骚穴	色情
吴百益	色情
魔域	色情
ｚｈｅｎｇ ｑｉ ｈｕａｎ ｘｉａｎｇ	色情
强奸26岁处女全过程/淫妹阴毛小穴	色情
少女一丝不挂做爱淫水直流！	色情
死全家	色情
内射美妇	色情
毛私/服	色情
孫中山	色情
强奸32岁处女全过程/淫妹阴毛小穴	色情
fuck色情	色情
女尔	色情
十年动乱	色情
淫网	色情
山西黑砖窑	色情
法$論	色情
造爱	色情
曹剛川	色情
淫女炮图	色情
高麗棒	色情
领取	色情
陰唇	色情
大纪园	色情
肉棒快速抽插	色情
回民人吃猪肉	色情
as$hole	色情
ｐａｏ ｐａｏ ｄａｏ	色情
八九學潮	色情
王八	色情
法**綸	色情
狗日的	色情
meimei的小屄好痒	色情
和条友做爱	色情
法^^淪	色情
毛海洋局	色情
萬鋼	色情
丝袜淫妇	色情
免费电影未亡人柔肌	色情
搓揉裸露在外的那对奶子	色情
山西洪洞	色情
聖堂科技	色情
成人视频	色情
操操GM	色情
薩達姆	色情
mm在线电影a片3级片	色情
bastard	色情
基督教	色情
纪股票市场五卅惨案	色情
吳德	色情
操gM	色情
吸毒	色情
游龙在线	色情
成人激情性爱电影网	色情
淫乱军团	色情
鸨	色情
艾滋	色情
發掄	色情
欽 本 立	色情
瓜娃子	色情
姐姐的肥穴	色情
ji zhan	色情
操得直叫爽	色情
淫奸护士jiejie穴	色情
邹德威	色情
allsexpages	色情
毛古方迷香	色情
私！服	色情
好色cc	色情
免费在线淫电影欣赏	色情
%共产党烂逼	色情
生成身份证	色情
QQtang	色情
淫护士电影	色情
社会主义	色情
点卡	色情
每天24小时循环更新的免费色情内容	色情
淫妻的穴	色情
野合	色情
av小电影	色情
fuck司法部	色情
射奶	色情
毛枪支弹药	色情
19岁女生主动让男生开苞全过程◥免费黄色电影	色情
口淫	色情
陰精	色情
牛逼靠	色情
插穴手淫	色情
吳 百 益	色情
齊藤亞樹	色情
da hai zhan	色情
ｊｉａｏ ｃｈｕａｎｇ	色情
把舌头伸入姐姐的	色情
强奸24岁处女全过程/*妹阴毛小穴	色情
365情色网	色情
毛二屄	色情
骚屄淫水泛滥	色情
分裂國家	色情
免费在线淫奸mm电影	色情
毛妳娘的	色情
大龟头顶紧子宫口	色情
杨思敏	色情
淫乱狂穴	色情
梅花網	色情
智能Ｈ３	色情
奶娘	色情
性饥渴	色情
色狼	色情
袁纯清	色情
肉棒插入meimei的肉缝	色情
装逼	色情
政治反对派	色情
偷情宝鉴	色情
我操你	色情
杨得志	色情
不需付费的色情电影	色情
原味丝袜	色情
毛温家宝	色情
色情导航 排行榜	色情
meimei┅┅爽快┅┅死了	色情
杨尚昆	色情
伸入蜜穴	色情
毛三个代婊	色情
抽插30岁处女妹妹淫叫不断	色情
ｐｋ1937	色情
买卖枪支	色情
妈妈美穴	色情
大陆性meinv淫穴	色情
jiejie的嫩阴户	色情
挂	色情
netbar	色情
日本淫色	色情
gameline	色情
魔法飛球	色情
发^轮	色情
毛阴小撕大	色情
操GM	色情
法^侖	色情
麦角酸二乙基醯胺	色情
小屄又湿又滑	色情
張 林	色情
腾武	色情
teensexy	色情
空降	色情
两性淫乱贴图	色情
啊 ……用你的鸡吧插我	色情
招雞	色情
Gカップカリスマ店員松嶋れいな20連発中出し！	色情
公车淫奸jiejie	色情
法$$沦	色情
紫彩乃潮吹赛红音	色情
激情貼圖	色情
dick dick	色情
免费午夜成人影院	色情
淫荡meinv医生	色情
毛军国主义	色情
fuck太监	色情
meinv口含鸡吧玩内射	色情
操陈毅	色情
毛淫荡	色情
账号	色情
海乐神	色情
不注册免费淫电影	色情
激情玩穴电影	色情
淫水四溅	色情
潮姫 史上最高の潮吹き女	色情
吃雞巴	色情
pp243淫色导航	色情
口射	色情
正清網	色情
少女被强奸到高潮时偷拍小A片	色情
阳具对准她湿润的小穴口	色情
姦汙	色情
365情色小说	色情
流氓	色情
哥哥淫奸meimei论坛	色情
安全隱秘	色情
高级淫口手淫口交	色情
国外meinv黄网 meinv激情SM处女淫水图台	色情
卖骚	色情
毛氵去	色情
瞳	色情
國家總理	色情
干妳马	色情
毛他妈	色情
逼	色情
肉棒插入嘴	色情
民族分裂	色情
淫婦自慰	色情
K房	色情
抽插22岁处女妹妹淫叫不断	色情
淫荡老师穴	色情
操妳娘	色情
亚洲淫色	色情
戴海静	色情
发^^轮	色情
朱巨	色情
金槍不倒	色情
妹妹的阴道好紧啊	色情
专政	色情
ｊｉ女	色情
9城	色情
孙逸仙	色情
淫水大量流出	色情
亂世三國	色情
免费成人激情影院	色情
江八	色情
台湾午夜色情小说	色情
社會主義	色情
MM视频聊天室	色情
爽女美图	色情
淫荡女mm的嫩穴 老师嫩穴	色情
好硬的肉棒	色情
urTNND	色情
沧澜曲	色情
肉棒插入妹妹的肉缝	色情
淪功	色情
大阳具	色情
亚甲二氧基甲基安非他明	色情
發**綸	色情
國軍	色情
曼德拉	色情
奇淫寶鑒	色情
毛气象局	色情
阴道夹裹住阴茎	色情
免费淫区隐蔽入口	色情
李旺阳	色情
大陆娱乐黄站	色情
滥交	色情
下体	色情
激情视频聊天论坛	色情
肉棒顶开阴唇	色情
功夫online	色情
鸡鸡插入穴嫩	色情
性病	色情
神出鬼没!3个丁字裤辣妹到处袭击肉棒(中文字幕)	色情
g m	色情
操达赖喇嘛	色情
江油餘震	色情
路甬祥	色情
ａｓｇａｒｄ	色情
王昊	色情
游衍	色情
蒙獨	色情
我淫我色淫色导航	色情
毛骡干	色情
小穴流出汁液	色情
qian nian	色情
zhengjian皮條	色情
你爺爺的	色情
干一家	色情
美国激情淫色网站	色情
午夜影院秘密通道_免费不需注册看电影	色情
大话	色情
干老师小穴	色情
武林外史	色情
免费淫奸女Ａ片段试看 令人喷血的春宫108姿势(组图)18岁禁看	色情
干X	色情
英雄纪念碑	色情
毛李宏旨	色情
龟头顶开阴户	色情
卡弗蒂	色情
新魔界	色情
戳b	色情
站前留學 外國人英語會話教師的癡態紀錄 (3月作品)	色情
白嫩骚妇	色情
NeoSteam	色情
婊子	色情
国家机密	色情
fuck煞逼	色情
私人服务器	色情
文 革	色情
性战擂台	色情
在线免费观看黄片Ａ片	色情
强*十八岁meinv护士看完保证你打飞机免费电影网站	色情
小电影	色情
弟弟淫奸jiejie论坛	色情
淫贼	色情
綸	色情
巡查員	色情
新闻出版总署	色情
交媾	色情
欧美尤物炮图图库	色情
厕所盗摄美女淫穴	色情
淫荡痴女	色情
QB	色情
老人政治	色情
护士脱衣图台湾激情电影	色情
黑马@美女全身神秘黑让你爽到眼框黑	色情
抽插49岁处女meimei淫叫不断	色情
色mm激情图片	色情
毛乳	色情
戴 相 龙	色情
色情淫图	色情
退党	色情
装B	色情
午夜激情情色网	色情
黄翔	色情
ｐｅｎｇ ｐｅｎｇ ｂａｎｇ	色情
干X娘	色情
毛肉壁	色情
聖女峰	色情
中原油田	色情
和两勇男玩16P	色情
欧美清晰打炮能看的淫乱	色情
江豬媳	色情
…好舒服…小穴	色情
阴户	色情
肉棒狂插小嫩B	色情
去氧麻黄堿或安非他命	色情
梅德韦杰夫	色情
鸡店	色情
yifeng	色情
中共/中共中央	色情
将阴茎尽根插入	色情
55xp。com 电影免费	色情
淫电影//居然花钱请人教性爱姿势(组图)	色情
5173	色情
BI	色情
二奶大奖赛	色情
毛淫水	色情
色meimei乱伦理小说	色情
fuck上妳	色情
操达赖	色情
┸	色情
坦克寶貝	色情
淫荡教师穴	色情
┏	色情
fuck外专局	色情
乌云其木格	色情
毛国际法院	色情
U/R	色情
毛睾丸	色情
小穴任由大鸡吧来回抽插	色情
仿真假钞	色情
hua xia	色情
教你怎样延迟射精29岁以下禁免费淫电影a片	色情
台湾成人24贴图	色情
秘密通道	色情
美女高潮	色情
淫穴 大鸡巴	色情
肏妹妹淫屄	色情
情色天堂论坛咪咪情色论坛	色情
外/掛	色情
街上钓个漂亮马子回家玩	色情
情色小电影	色情
90bb成人小电影	色情
法^^伦	色情
海洋局	色情
骚妹妹	色情
meretriz	色情
hong yue	色情
肉棒抽插……的爽死了	色情
公安局	色情
ａｎ ｈｅｉ ｚｈｉ ｍｅｎ	色情
骚女	色情
目標軟體	色情
大鸡巴 用力地干	色情
新唐人電視臺	色情
娘个比	色情
操淫荡护士	色情
吗的靠	色情
妖艷醫生	色情
公公狂操儿媳妇小穴	色情
湿穴	色情
网址之家	色情
张 万 年	色情
小灵通	色情
多维新闻	色情
巴黎市长	色情
鐵血三國志	色情
混沌靠	色情
强制浣肠	色情
黄色淫电影/大幅的陰毛覆蓋著她的迷人洞	色情
c a o	色情
二b	色情
毛共产党	色情
天鹅之旅	色情
事实独立	色情
fuck倭寇	色情
強制飲尿便器小野悠美	色情
民國	色情
ling tu	色情
把舌头伸入jiejie的	色情
17岁处女小阴唇张开	色情
我的淫荡老师	色情
轮奸做爱高潮	色情
安息	色情
TOM在线	色情
小嘴吐出龟头	色情
林榮一	色情
操那吗逼	色情
苯丙胺	色情
毛刘　淇	色情
在乳房和阴道mo弄	色情
欧美暴淫 rsync 月宫成人贴图区	色情
暴力虐待	色情
feng wu tian jiao	色情
林文漪	色情
blogbaby	色情
3p	色情
幹穴	色情
第7色大型黄色网站	色情
刘杰	色情
薄碼	色情
貓撲	色情
毛王乐泉	色情
發~~淪	色情
妈卖妈屁	色情
免费激情电影 爽电影	色情
嫖	色情
奸淫空姐	色情
少妇淫心我要看淫心情迷电影淫心情迷电影	色情
朱骏	色情
酱猪媳	色情
毛靠	色情
妈妈的阴道好紧啊	色情
拍肩神药	色情
陈永贵	色情
法*伦	色情
互友财富	色情
又紧又嫩的屄	色情
林心如做爱*色情电影*免费淫电影a片	色情
色成人	色情
9之遊	色情
妳妈的	色情
军国主义	色情
本站10010多部激情电影全部免费试看	色情
做爱视频表演黄色小说	色情
邻居美少妇 操淫荡少妇	色情
御の二代目	色情
傻批	色情
我受不了啦!┅┅好勇猛的鸡巴	色情
台湾獨立	色情
熟女亂倫	色情
法$伦	色情
免费淫奸女Ａ片段试看 淫电影//少女被强奸到高潮时偷拍小A片	色情
falundafa	色情
夢城互動	色情
毛新疆独立	色情
肉棒插入阴道	色情
房事	色情
膏药旗	色情
毛萨达姆	色情
色meimei成人论	色情
fuck外—挂	色情
gu long qun xia zhuan	色情
368成人网站	色情
本站10019多部激情电影全部免费试看	色情
闹事	色情
教你怎样延迟射精41岁以下禁免费淫电影a片	色情
残忍老爸玩我小穴	色情
毛胡紧套	色情
一夜歡	色情
男人本色	色情
gmworkers	色情
破天一劍	色情
舌尖舔着肉棒 阴门	色情
毛烟草局	色情
啊…我的亲丈夫…用他的手…插…啊…啊…进了人家的小穴	色情
阴道图打手枪专用	色情
Early Melissa Lauren	色情
李 少 民	色情
激情淫色mp3	色情
罗富和	色情
大鸡吧塞进逼里使劲插我	色情
机八	色情
日GM	色情
ｗａｎ ｗａｎｇ ｚｈｉ ｗａｎｇ	色情
53淫色导航	色情
大肉棒插进我的肉屄	色情
一夜性網	色情
政治压迫	色情
毛美利坚	色情
洪興	色情
ｂ	色情
淫奸妹妹论坛	色情
阴茎被子宫夹住好爽	色情
家庭教师は女子校生 藤沢美歩	色情
鄒德威	色情
Archlord	色情
于天瑞	色情
戰國英雄	色情
机机歪歪	色情
鹽酸二氫埃托啡	色情
臺灣狗	色情
台独	色情
ming yun	色情
嘴唇吸小肉缝	色情
法$$淪	色情
游戏指导员	色情
东正教	色情
法*掄	色情
jhwg	色情
社会院	色情
fuck	色情
kakajb	色情
色欲	色情
干死GM	色情
锦涛	色情
奸杀美女大学生	色情
肉棒狂插流出淫液	色情
姐弟激情淫影片	色情
乘骑按摩	色情
手记注册日韩5016部激情电影	色情
日本性爱电影	色情
李老師	色情
淫荡少妇穴少妇嫩穴 meinv的嫩穴	色情
俪影蝎心	色情
色情聊天室	色情
和两勇男玩14P	色情
毛罗干	色情
Groove	色情
狂操少妇逼	色情
張立昌	色情
强奸18岁处女全过程/*妹阴毛小穴	色情
淫水横流	色情
少妇房中自淫，和两勇男玩16P，操得直叫爽 操日本淫女穴	色情
餘震	色情
唐人電視臺	色情
妹妹嫩穴	色情
居然花钱请人教性爱姿势(组图)免费淫电影a片	色情
射你	色情
白痴	色情
粉紅愛液	色情
fuck信息产业部	色情
淫货	色情
干你老母	色情
遺嘱	色情
毛台湾独立	色情
列寧	色情
磕藥	色情
抽插24岁处女meimei淫叫不断	色情
香港成人激情论坛	色情
陳雲	色情
后面插入处女肉穴深处	色情
淫秽小电影	色情
Kamikaze Girls Vol。23 : Haruka Kaede 枫はるか	色情
fuck小泉	色情
裸陪	色情
反封锁	色情
毛六合彩	色情
毛淫货	色情
上海帮	色情
騷小浪女	色情
┅你的大肉棒┅┅好粗	色情
淫湿	色情
成人激情论坛	色情
褲襪	色情
淫图	色情
nnd=	色情
伟哥	色情
重生	色情
自慰摳穴	色情
rxjhwg	色情
封神	色情
自由亚州	色情
彩票机	色情
毛连战	色情
怪獸總動員	色情
麻黄素	色情
敢坐飞机吗	色情
现金交易	色情
淫腔	色情
暴亂	色情
免费色站	色情
騷包	色情
遊戲宮理員	色情
毛贱人	色情
視娘辣妹	色情
免费免注册淫色电影	色情
台办	色情
免费电影	色情
突破封锁	色情
yi wang chuan shuo	色情
毛新闻出版总署	色情
肉棒插在阴道里	色情
狂插 嫩穴	色情
免费色情电影 强奸小说	色情
ｄｉ ｑｉｕ ｗｅｎ ｍｉｎｇ	色情
(Waap)女教師 盗撮 - 志保	色情
王太华	色情
爽穴	色情
骚浪	色情
日本灌腸	色情
paper64	色情
明慧網	色情
臺灣黨	色情
烏雲其木格	色情
你大爷	色情
強淫女優	色情
包皮	色情
奶头	色情
钱 国 梁	色情
屙民	色情
中华养生益智功	色情
毛法*轮*功	色情
春光外泻	色情
打倒中国	色情
黃菊	色情
美女潮吹	色情
毛酱猪媳	色情
黑逼	色情
和阿姨淫穴	色情
大鸡巴 大肉棒狂插嫩穴	色情
毛塞你爸	色情
丁元	色情
本站10007多部激情电影全部免费试看三天	色情
相奸	色情
大海战II	色情
10 Little Asians Vol。 14	色情
日本黄色电影	色情
taobao靠	色情
毛法仑	色情
成人激情asp电影通道	色情
八仙	色情
多维网	色情
操粗制吗啡	色情
公子开	色情
ｑｉ ｊｉ ｓｈｉ ｊｉｅ	色情
WEB牌戰	色情
肉棒狂插花心深处	色情
鬼輪姦	色情
kamikaze girls 07 Nagisa Sasaki	色情
免费淫色情电影	色情
C N	色情
温馨	色情
睡着的武神	色情
小魚兒與花無缺	色情
监狱	色情
你姥姥	色情
援助交际	色情
精液射进小穴里到了高潮	色情
淫女 喷精	色情
动漫色图	色情
艳妇淫女	色情
64xp。com 电影免费	色情
操护士的穴	色情
现场直播女主持人教你做爱	色情
分裂祖國	色情
玩弄她的骚屄嫩肉	色情
裸露自拍	色情
密穴貼圖	色情
电影	色情
免费注册激情视频聊天	色情
把阴户内塞得满满	色情
三国群英传	色情
金尧如	色情
国 贼	色情
六四事件	色情
大史记	色情
美少婦	色情
法lun功	暴恐
徐炳慧	色情
快到高潮时，他哭了。	色情
洪 傳	色情
短信群发器	其它
可怜系新人美少女甘南三才	色情
煞笔靠	色情
毛检察院	色情
laghaim	色情
法掄	色情
龟毛	色情
狗雜種	色情
台灣國	色情
李昌	色情
駛你老母	色情
丁香大型成人社区	色情
肉棒插入 嫩穴	色情
双腿夹著我的腰部使我的肉棒进入的更深	色情
李 總 理	色情
移彩联合	色情
╀	色情
jiejie的嫩穴 mm嫩穴	色情
ｐｕｓｓｙ	色情
毛老逼	色情
辉煌	色情
裸体插淫穴	色情
阴唇好嫩啊	色情
舌头舔着阴核	色情
mixmaster	色情
小B样	色情
露出了娇小鲜嫩的小屄洞	色情
國民黨	色情
Tora Tora Gold Vol。24~伊泽夕	色情
顶到了欣虹阴道最深处	色情
色情小说	色情
淫穢	色情
GP	色情
反動	色情
釋欲	色情
market	色情
操gm	色情
騷妹	色情
淫贱	色情
幹你妈逼	色情
插入阴道里抽插	色情
陈宣良	色情
陰阜	色情
日本激情淫色影院	色情
风骚护士	色情
插穴好舒服	色情
fuck温馨	色情
三去车侖	色情
弹劾	色情
法论功	色情
未满18岁的请自行离开 ！	色情
發~倫	色情
淫奸处女论坛	色情
床上激情自拍图	色情
插你奶奶	色情
戳	色情
風騷淫蕩	色情
盛雪	色情
U R靠	色情
103bb成人小电影	色情
真孔雀王	色情
狗卵	色情
免费试看片	色情
ｘｉｎ ｓｈｉ ｑｉ	色情
美国淫女在线看电影欣赏mm乱淫自拍图片	色情
fuck生孩子没屁眼	色情
卡卡金币	色情
韩国激情淫色贴图	色情
法@倫	色情
大膽少女	色情
亲哥哥……meimei的小穴……舒服死了……	色情
皮条	色情
愛妻淫穴	色情
法*	色情
打炮	色情
花蕊	色情
吸吮着红嫩的乳头	色情
傲神傳	色情
餓比	色情
你他馬的	色情
吴学灿	色情
阿姨的肥阴唇	色情
GC365	色情
所盗摄护士jiejie性感美腿图 肉丝美腿艳情淫欲	色情
色情 导航	色情
亲美	色情
精品性交图	色情
法$$倫	色情
激情黄色电影	色情
賽維創世	色情
抽插35岁处女meimei淫叫不断	色情
wg17173	色情
毛精液	色情
支持达赖	色情
免费淫电影试看	色情
幹他	色情
操爛	色情
抗震救災	色情
騷屄	色情
ｃａｏ你	色情
操你老母	色情
東升	色情
肉棒 好粗啊……	色情
插你娘	色情
毛王宝森	色情
你媽	色情
89年的鬥爭	色情
激情淫色	色情
干meinv小穴	色情
屌	色情
情色影院	色情
毛肛交	色情
我该死视频做爱	色情
肉棒插入骚穴	色情
掰穴	色情
空姐性交	色情
5kuai	色情
肉壁包容着鸡吧很舒服啊	色情
肉棒插入美穗子的肉縫	色情
数码精灵	色情
隱窩窩	色情
射了	色情
毛多维网	色情
踢踢球	色情
武力统一	色情
ｌｅｉ ｔｉｎｇ ｚｈａｎ ｄｕｉ	色情
天安门母亲	色情
華國鋒	色情
熟女	色情
蒋经国	色情
雞奸	色情
美女野兽做爱淫图	色情
贯通两极法	色情
六四死难者	色情
成人激情电影在线播放	色情
免费淫奸女Ａ片段试看 强*十八岁meinv护士看完保证你打飞机	色情
亞甲二氧基甲基安非他明	色情
张昭富	色情
老师的淫液	色情
仙界传	色情
毛审计署	色情
翘臀嫩逼	色情
綿阳	色情
免费淫色电影论坛	色情
pp点点激情	色情
百纳成人激情影院	色情
肉棒摩擦她屁眼里的嫩肉	色情
陈破空	色情
fuck台办	色情
fuck天安门录像带	色情
帶链	色情
在线淫色电影	色情
母乳と巨乳と淫乱の完熟物語	色情
処女強奪3穴串挿輪姦	色情
107bb成人小电影	色情
嫩肉 嫩肉 大腿	色情
毛轮奸	色情
阴穴	色情
戈扬	色情
厕所盗摄护士jiejie	色情
龟头紧顶她的子宫口	色情
苏绍智	色情
免费淫 电影	色情
強衛	色情
阴茎在殷素素的阴道里抽插	色情
出售枪支	色情
法~輪	色情
水利部	色情
激情网站	色情
舔我的龟头	色情
胡紧套	色情
吗b	色情
本站10006多部激情电影全部免费试看	色情
週六性吧	色情
发奖使者	色情
发@@论	色情
干他	色情
日軍	色情
海洛因	色情
大肉棒在妈妈的阴道	色情
去氧麻黃碱或安非他命	色情
(最新一本道)独占动画~薰~陵辱巨乳	色情
屄儿好┅┅好爽!┅┅好舒服!┅┅	色情
法$$抡	色情
我操靠	色情
5街区	色情
成人影院	色情
BT色工厂	色情
ｂａｉｃｈｉ	色情
嘻遊中國	色情
毛一中一台	色情
meimei社区淫色	色情
亚洲情色网	色情
操小姐穴	色情
熟妇	色情
本站10020多部激情电影全部免费试看三天	色情
毛血腥图片	色情
静坐	色情
男女激情淫乱图 林心如合成	色情
大龟头戳进了子宫里	色情
gc365	色情
操吃大便	色情
美女直播做爱	色情
梦幻国度	色情
抽你丫的	色情
rxjhvip	色情
刘宾深	色情
淫之插穴虐待破处流血	色情
妹妹的大阴唇好嫩啊	色情
萬歲	色情
日本激情淫骚穴	色情
meimei嫩穴被狂插	色情
J8	色情
Tora Tora Gold Vol。14 星野みく	色情
干小姨子小穴	色情
日本成人激情论坛	色情
断電	色情
毛鸡叭	色情
肉棒插入少妇的阴户内	色情
完美世界	色情
我讓朋友強姦我的小姨子	色情
性交淫图	色情
賣ID	色情
艷照门	色情
官人我要	色情
九評共產黨	色情
美穴張開貼圖區	色情
例假	色情
毛外—挂	色情
KOKESHI COWGIRL Vol。29 石川优季奈	色情
装备展示	色情
淫荡的妈妈8淫荡护士9淫荡空姐	色情
义母	色情
新石器时代	色情
礼品	色情
毛钱其琛	色情
白嫩美女穴	色情
寂寞自摸	色情
狂插淫洞	色情
赵紫阳	色情
赛妳阿母	色情
毒販	色情
wu jin de ren wu	色情
家人一起凌辱母亲和叔母	色情
迫害	色情
免费淫*黄色电影a片	色情
老味	色情
吴德	色情
│	色情
不像我讓你打~	色情
ｑｑ音速	色情
老比	色情
煞笔	色情
巨炮肉穴	色情
港激情图源成人色情论坛	色情
┰	色情
bi xue qing tian	色情
wizard-soft	色情
mo你鸡巴	色情
女教師赤版免费下载	色情
韓啟德	色情
插我	色情
操你妈	色情
共产党靠	色情
人肉	色情
淫奸电影 淫色猎暴淫电影	色情
法~侖	色情
籐原紀香Norika Fujiwara SEX	色情
夏夏娱乐 黄站电影	色情
navyfield	色情
强奸27岁处女全过程/淫妹阴毛小穴	色情
强奸林心如扒开阴道	色情
腾任	色情
少女被逼吃精喝精轮奸灌精	色情
哥白尼	色情
江戏子	色情
血腥内幕	色情
国管局	色情
台灣獨立	色情
保监会	色情
発射	色情
毛贱逼	色情
银行帳號	色情
蓮花逼	色情
十八岁meinv护士电影网站	色情
泡泡岛	色情
父亲	色情
99BBS	色情
温家寶	色情
毛海洛因	色情
爸干得你┅┅舒服	色情
成人小电影	色情
睪丸	色情
激情淫色电视	色情
毛江戏子	色情
海科數碼	色情
日本人淫乱操淫荡少妇操淫荡meimei	色情
鹿城娱乐情色	色情
中华人民共和国	色情
政治局	色情
香港激情淫色影院	色情
色情导航 免费色情电影	色情
法@伦	色情
給你爽	色情
李兆焯	色情
母子做爱	色情
鸦片	色情
干你媽b	色情
久游	色情
淫战群P	色情
股市民谣	色情
激情淫色下载	色情
21ｃｎ	色情
又嫩又紧的阴户	色情
革命	色情
黄色免费淫电影网	色情
毛兴奋剂	色情
老毛子	色情
新江湖	色情
手记注册日韩5012部激情电影	色情
狂插妹妹小穴	色情
亚洲激情淫色贴图网	色情
诱奸	色情
淫奸jiejie穴	色情
淫告白	色情
塞你公	色情
輪公	色情
操迟浩田	色情
免费淫奸女直接试看	色情
插嫩逼	色情
h r i c h i n a	色情
毛李先念	色情
性虎色网	色情
法@@論	色情
妈b	色情
卖ID	色情
20岁女大学生被强#(组图)全过程	色情
毛四人帮	色情
裹本	色情
初流出！ロリプリ	色情
小便	色情
张春桥	色情
舌头伸到妈妈的小穴里	色情
fuck生春袋	色情
白虎陰穴	色情
淫婦	色情
操你奶奶	色情
(无)导航网站连接	色情
独夫	色情
密传	色情
免费电影 美女电影	色情
中国meinv淫色贴图	色情
成人激情asp电影通道 黄色免费电影 sp色情播放	色情
你它媽的	色情
免费淫电影论坛	色情
妹妹的阴蒂	色情
叫小姐	色情
phuc	色情
尻庇	色情
meinv极品穴	色情
蔣經國	色情
带套肛交	色情
Bi样	色情
高畫質~ 超絕美貌社長秘書 佐佐木渚沙！【WMV/102MB】	色情
┙	色情
現役看護婦下载	色情
厕所盗摄护士姐姐	色情
国产熟女做爱深喉肛交无码	色情
發*輪	色情
毛江猪	色情
master	色情
向忠发	色情
988wow	色情
UltraSurf	色情
跟妹妹肏穴好舒服	色情
少妇野外淫穴电影	色情
鲜嫩蜜穴	色情
淫女嫩穴图	色情
摸擦小肥穴	色情
內射	色情
台湾成人25贴图	色情
日本淫色动画片	色情
欲望成人3GP视频	色情
淫奸小姨论坛	色情
黑社會	色情
鸡8	色情
ｔｏｍ在线	色情
SYSTEM	色情
厕所盗摄meinv淫穴	色情
法@轮	色情
卓奥	色情
鸡巴受不了了┅┅喔┅┅好爽┅┅我要泄了┅┅	色情
陈一谘	色情
mo yu	色情
freedom	色情
快活林情色网	色情
淫水留入穴中	色情
大奶头	色情
少女被操喷精图	色情
中國分裂	色情
喔…快…爽死	色情
又粗又长的肉棒	色情
尾行	色情
阴壁的嫩肉夹得我非常舒服	色情
Media	色情
嘭嘭帮	色情
郭 罗 基	色情
两性激情电影	色情
臀部猛烈的撞击	色情
胡耀帮	色情
阿姨的阴道好大	色情
刘亦菲淫阴道流血色片	色情
淫液不断从穴里流出	色情
两会报道	色情
ur	色情
羞耻母	色情
淫妻乱交	色情
好爽……顶得好深啊……	色情
干妳老母	色情
毛可卡叶	色情
万里	色情
吾爾開希	色情
堕淫	色情
黑鮑嬌	色情
热血传奇	色情
操嫩穴	色情
全国两会	色情
日你九城	色情
輪暴	色情
肉棒插入meimei小穴	色情
被老师强奸的小初中生	色情
女添男精狂射图	色情
操淫女穴贴图	色情
日本情色淫电影	色情
中廣網	色情
骚B	色情
骚姨妈	色情
Kamikaze Premium Vol。 8	色情
毒龙舔脚	色情
美女视频短片	色情
麦角酸	色情
47xp。com 电影免费	色情
好大的阴户啊	色情
妈**菊花穴	色情
六四正名	色情
骚姐姐	色情
下三濫	色情
抽插22岁处女meimei淫叫不断	色情
充值	色情
災区	色情
用舌尖在我的肉棒上舔	色情
本站10004多部激情电影全部免费试看	色情
性欲喘息教師	色情
王子淫传	色情
午夜剧场成人视频聊天	色情
阴茎挺进滋润肉洞里在阴户中抽送	色情
【亚洲/无码】【极品荡女-宝乃ありか 完結版！】【WMV/358MB】	色情
urban靠	色情
ygbh	色情
伊拉克	色情
ｆ_ｕ_ｃ_ｋ	色情
美国凯德	色情
b样	色情
馬英九	色情
999日本妹	色情
厕所盗摄护士jiejie性感	色情
meinv激情视频聊天室	色情
手记注册日韩5031部激情电影	色情
操死	色情
毛吴官正	色情
管理人员	色情
薛伟	色情
日本素人	色情
情色艺术天空	色情
法^轮	色情
我该死免费色情电影	色情
┗	色情
卖软件	色情
日你妈靠	色情
發*侖	色情
肏又紧又嫩的穴	色情
大力丸	色情
15768	色情
榮毅仁	色情
大鸡吧来回抽插着小穴	色情
最新两性激情小说	色情
毛性爱	色情
polla	色情
高丽樸	色情
和护士jiejie淫穴	色情
gn	色情
淫液	色情
meimei的嫩阴唇	色情
幹妳馬	色情
色mm穴激情图片	色情
抵制奥运	色情
賓周	色情
插 操 干 骚穴 嫩穴 小穴 密穴 淫水流	色情
毛神经病	色情
ｍａｄｅｌｏｖｅ	色情
fuck铁道部	色情
H淫乱乳娘 Tora Tora Gold Vol。23 星之雪	色情
王若望	色情
ZD	色情
毛麻醉钢枪	色情
张筱雨	色情
强奸38岁处女全过程/淫妹阴毛小穴	色情
错那吗B	色情
网星	色情
毛新闻出版署	色情
體奸	色情
掩埋	色情
教你怎样延迟射精27岁以下禁免费淫电影a片	色情
42lian色站大全	色情
在线播放a级电影	色情
韦国清	色情
人民日报	色情
狗杂种	色情
插 4p	色情
发@@仑	色情
政治避难	色情
小MM	色情
爛逼	色情
李洪智	色情
插 14p	色情
中央电视台	色情
奴役童工	色情
淫民俱乐部和meinv发春激情3级片试看	色情
水滸Q傳	色情
本站是国家合法电影网请您用手机注册～！	色情
绿色环保手机	色情
做爱视频	色情
ｍａｓｔｅｒ	色情
干入	色情
駛你娘	色情
泄题	色情
大乳頭	色情
精神病	色情
博訊	色情
gy	色情
臺灣共和國	色情
傻鳥	色情
自拍	色情
大鸡巴顶进妹妹的小穴	色情
和妹妹玩插穴	色情
Gamemanger	色情
淫声浪语	色情
butthole	色情
老癟三	色情
肉欲	色情
淫水和精液浸濡的小穴里	色情
三民主義	色情
天安門錄影帶	色情
賣財富	色情
戴秉國	色情
林心如做爱网有激情自拍裸体图片	色情
性爱图库	色情
毛反革命	色情
毛希望之声	色情
朱容雞	色情
口内爆射	色情
拉登	色情
臺灣獨立	色情
情色	色情
抗震救灾	色情
幹一家	色情
素人娘	色情
台湾成人免费情色电影	色情
官方管理者	色情
毛麻醉乙醚	色情
又大又嫩的阴户	色情
西藏	色情
鲍岳桥	色情
謝長廷	色情
少妇房中自淫，和两勇男玩10P，操得直叫爽 操日本淫女穴	色情
抽插45岁处女妹妹淫叫不断	色情
毛骚	色情
大陆性美女淫穴	色情
現場直播~女主持人教你做愛	色情
毛龟孙子	色情
suck你媽的	色情
招鸡	色情
激情贴图	色情
色97愛	色情
我使劲快速抽插龟头好麻	色情
鸡巴 嫩穴 淫荡	色情
抽插18岁处女meimei淫叫不断	色情
处女的阴道特别紧	色情
李贵鲜	色情
毛干gM	色情
gamegold	色情
劍俠情緣OnlineII	色情
zhengqing	色情
手记注册日韩5018部激情电影	色情
祁培文	色情
看单亲妈妈给儿子的性启蒙	色情
毛情色	色情
av成人电影网	色情
ｘｉｎ ｚｈｅｎｇ ｈｅ	色情
床上功夫	色情
肉棒在姐姐的阴道里	色情
免费操小姨子 操小姨	色情
爱色cc	色情
又肥又大的阴户	色情
Parade Vol。57：巨乳絞りボンデージ	色情
yuckfou	色情
CM	色情
轮盘赌	色情
发@抡	色情
Red Hot Jam Vol。6 Chiaの露出初体験	色情
J-Girl 双穴~水原 小笠原崎	色情
林彪	色情
蝉童	色情
韩杼滨	色情
怎样延迟射精21岁以下禁	色情
完全免费在线淫电影	色情
fuck外_挂	色情
猪猡	色情
滚滚球	色情
杀手	色情
誘色uu	色情
mm美圖	色情
jiejie	色情
小日本爆撮中国女子大生vol。01	色情
你的小穴好紧┅┅夹┅┅夹得我好舒服	色情
幼圖	色情
操插你妈	色情
赤化	色情
毛卖比	色情
san guo yan yi	色情
共产党	色情
Fuck You	色情
獸奸	色情
交通部	色情
毛塞你老师	色情
虎虎虎~ Tora-Tora Platinum Vol。1 金沢文子	色情
女大学生在夜店被朋友轮奸	色情
淫奸少妇电影	色情
十八岁美女护士电影网站	色情
奶頭	色情
李 錄	色情
hellgate:london	色情
活动管理员	色情
bt淫色电影	色情
快乐西游	色情
幹你良	色情
最淫成人贴图区	色情
淫民俱乐部做爱顶级	色情
扒开她的嫩阴道	色情
抽叉姐姐	色情
大龟头顶住子宫深处	色情
日本黄色小电影	色情
牛魔王	色情
法^^论	色情
淫色网站导航	色情
乳波臀娘	色情
摩力遊	色情
公安部	色情
龔学平	色情
强效失意药	色情
肉縫分開大腿	色情
老江	色情
奸污	色情
少妇激情电影	色情
把大龟头对准她的阴道口	色情
駭客	色情
做愛寫真集	色情
成人激情淫影院	色情
无界浏览器	色情
江折民	色情
欧美淫图 成人色情网	色情
六合彩	色情
毛骚B	色情
travestido	色情
毛狗屁	色情
阴唇阴道	色情
粗壯的肉棒插入淫蕩的小穴	色情
扒开嫩穴 抚摩她的嫩穴 下身也不停的抽插着	色情
强奸大奶嫩逼meinv	色情
毛阴毛	色情
性交吞精	色情
操操你	色情
情色电影注册观看	色情
ｇｒｏｏｖｅ ｐａｒｔｙ	色情
fuck王八蛋	色情
好紧的屄	色情
午夜成人电影	色情
毛佛祖	色情
靠夭	色情
天安門屠殺	色情
欧美激情穴淫奸	色情
党卫兵	色情
午夜成人	色情
滾那嗎	色情
fuck死gd	色情
ＮＥＴ	色情
马加爵	色情
106bb成人小电影	色情
淫奸处女电影论坛	色情
护士掰开阴道插B	色情
你妈靠	色情
牙齿轻咬他的龟头	色情
福摩萨	色情
中青旅創格	色情
仆街	色情
meinv穴自拍	色情
淫色五月天	色情
蒋中国	色情
嫩穴肉縫	色情
搞她	色情
淫女信息	色情
mm穴激情小说	色情
賤貨	色情
机吧	色情
懒叫	色情
碧雪情天	色情
分裂中国	色情
免费淫色妹妹电影	色情
免费成人meinv	色情
毛法轮大法	色情
如果你未满29周岁请自觉离开。	色情
无码内射	色情
賀國強	色情
香港	色情
21世纪中国基金会	色情
风骚女秘书	色情
宏象	色情
阴唇上摩擦着	色情
她媽的	色情
今晚我把表姐操上了	色情
习仲勋	色情
对日强硬	色情
射精女皇系列Ladies In Lust	色情
鄭萬通	色情
法@@侖	色情
手记注册日韩5013部激情电影	色情
愛圖公園	色情
捏你奶子	色情
賤逼	色情
法~纶	色情
淫荡老师	色情
勾魂少妇	色情
李師傅	色情
学联	色情
www。qq965。com	色情
阴茎插入肉洞	色情
女尻	色情
私**服	色情
ｔａｎ ｋｅ ｂａｏ ｂｅｉ	色情
淫奸小姨子穴	色情
毛克林顿	色情
豔婦淫女	色情
肉穴肥肥的裹着阴茎	色情
李录	色情
绵恒	色情
外阴	色情
林长盛	色情
插的meimei流淫水	色情
星蓝妹妹	色情
奇乐网	色情
胡XX	色情
幹bi	色情
狂插meimei穴	色情
幼男搞幼女	色情
毛肛门	色情
法輪	色情
蒙古达子	色情
发论公	色情
强奸20岁处女全过程/淫妹阴毛小穴	色情
小日本	色情
ｂｉｎｇ ｆｅｎｇ ｃｈｕａｎ ｑｉ	色情
咬着她的奶头干了她	色情
众志成城	色情
外~~挂	色情
處女小穴 阴毛	色情
朱熔基	色情
操淫荡少妇穴 操淫荡meimei穴 操淫荡jiejie穴	色情
诱惑骚妹	色情
小肉粒	色情
免费视讯meimei	色情
新鄭和	色情
赫鲁晓夫	色情
笨比	色情
卫生棉条真人使用图	色情
姐姐的阴户好嫩啊	色情
轮奸内射	色情
熟女护士	色情
它NND	色情
五月天	色情
儿子淫奸jiejie	色情
亞洲風暴情色	色情
紧致小穴抽插	色情
肥厚柔软的大阴唇夹着大龟头	色情
┈	色情
毛刘军	色情
SUCK	色情
肥嫩的阴唇	色情
一个事实	色情
肉棒全部插入	色情
肉棒插入美穗子的肉缝	色情
14se淫色图片	色情
温家宝靠	色情
亚洲淫娃	色情
台湾十八电影	色情
fuck邪教	色情
法院	色情
林心如毛片	色情
計牌軟體	色情
淫电影免费在线观看	色情
操蛋	色情
肉穴 大鸡巴 ……骚穴	色情
那吗错比	色情
真理教	色情
安非他命	色情
新手輔導員	色情
毛淫毛	色情
勁乐	色情
抽插36岁处女meimei淫叫不断	色情
三個代婊	色情
┽	色情
斯诺	色情
成人自拍	色情
fuck他妈	色情
性免费电影	色情
ｌｉｕ ｘｉｎｇ ｘｕｅ ｙｕａｎ	色情
淫奸护士穴	色情
欠幹	色情
三级电影网香港色情服务	色情
性福联盟	色情
信访局	色情
哥伦布	色情
毛国防部	色情
从后面插漂亮小穴妹	色情
conquer	色情
大鸡吧在她的小嘴抽送	色情
极品成人激情影院	色情
经典炮图	色情
毛售ID	色情
法国	色情
毛妹妹黄站	色情
插穴止癢	色情
滥比	色情
妳她妈的	色情
江口美貴 桃咲あい 早乙女みなき 雨宮せつな	色情
國研	色情
性愛圖片	色情
大衛教	色情
陈锡联	色情
强卫	色情
红卫兵	色情
潮噴	色情
色妹妹乱伦理小说	色情
fuck吴仪	色情
欧美淫图片 咪咪爱论坛	色情
webmaster	色情
亚洲淫色贴图365	色情
狗娘養的	色情
Priston Tale	色情
骚妹	色情
观世音	色情
法$淪	色情
激情淫穴导航	色情
minhui	色情
杨建利	色情
台灣民國	色情
毛卖。国	色情
少妇房中自淫，和两勇男玩3P，操得直叫爽	色情
戳B	色情
sphincter	色情
我就去色	色情
文胸	色情
毛买卖枪支	色情
亚洲淫色俱乐部	色情
抢火炬	色情
奸淫女老师	色情
毛十八摸	色情
銷售	色情
插那吗比	色情
嫩縫	色情
激情成人桃色电影	色情
鸟gM	色情
傻B靠	色情
巧淫奸戲	色情
狂插	色情
如果你未满23周岁请自觉离开。	色情
激情小浪穴	色情
发*伦	色情
鸡巴插进穴	色情
领导	色情
阻无通畅	色情
民猪	色情
j8	色情
初中meimei的小美穴	色情
儂著岡巒	色情
台湾19岁成人	色情
本站10003多部激情电影全部免费试看	色情
法轮攻	色情
親民黨	色情
meinv激情SM处女淫水	色情
h站靠	色情
带练	色情
母子淫奸乱轮现场看……扶正肉棒	色情
中华人民正邪	色情
毛佳静安定片	色情
狡猾的风水相师	色情
熟睡中的meimei	色情
365激情淫色贴图	色情
騷浪	色情
屆中央政治局委員	色情
他嗎的	色情
连战	色情
人民银行	色情
64	色情
18摸	色情
法$$纶	色情
18歲少女	色情
狂操丰满小姨穴	色情
龟头在阴户抽插	色情
省长的儿媳妇	色情
天翼之链	色情
feng shen	色情
奥巴马	色情
免费淫奸黄色淫乱电影	色情
狂插日本meinv护士	色情
骚妇掰b	色情
毛三陪女	色情
毛口交	色情
干七八	色情
法@@论	色情
美女激情SM处女淫水	色情
抽插51岁处女meimei淫叫不断	色情
下三滥	色情
天安門	色情
好色meimei电影做爱论坛	色情
朝天穴	色情
网特	色情
礼品机	色情
淫奸姐姐穴	色情
fils de pute	色情
毛片	色情
天下無雙	色情
cocksucker cocksucker	色情
裸聊日本成人电影	色情
刚度	色情
操浪妻淫女	色情
幹逼	色情
ｘｉａ ｙｉ ｄａｏ	色情
发$$论	色情
平反六四	色情
lastchaos	色情
发~轮	色情
操操比	色情
wow520	色情
無碼體驗	色情
B样	色情
ustibet	色情
毛小泉	色情
政變	色情
cunt cunt	色情
值勤帐号	色情
共產黨	色情
国产无码	色情
操的我好爽啊……我又要泄┅┅	色情
淫穴贴图论坛	色情
賤bi	色情
侨办	色情
将肉棒对准她的穴口	色情
毛他母亲	色情
钦本立	色情
偷窥拍摄	色情
野性姐妹花	色情
免费操小姨子 操小姨 操小姐图片 操小姐小说 操小姐自拍 按摩洗浴操小姐 操外国小姐b	色情
秦 晋	色情
赵洪祝	色情
起义	色情
毛马克思	色情
反腐败论坛	色情
去她妈	色情
肉棒不斷的抽插著她的肉體阴道口	色情
立即登陆观看激情爽片	色情
成克杰	色情
fuck十五周年	色情
政治封锁	色情
社。会。正。义。力。量	色情
吾尔开西	色情
含着他的龟头	色情
三去車侖工力	色情
你媽比	色情
马凯	色情
激情 乱伦 性	色情
姦	色情
牛逼	色情
Premium)オトナの変态●稚园 神谷姫	色情
激情午夜	色情
插的妈妈好爽	色情
斑竹	色情
共黨	色情
制服美妇	色情
卵子	色情
发*纶	色情
不用注册免费淫电影	色情
男女激情淫影片图片	色情
群陰會	色情
驚天動地	色情
extremeskate	色情
淫女与猪乱搞图	色情
撒切尔	色情
┻┼	色情
小姨子她饱满乳峰上的粉红乳晕，金发表姨花蕊	色情
絲路傳說	色情
宋平	色情
熟女護士	色情
亚洲激情淫色文章	色情
日本黄色三级短片	色情
討伐中宣部	色情
上床	色情
大鸡巴插进妹妹的小穴	色情
┍	色情
FALUN	色情
插进少女粉红阴道	色情
手记注册日韩5019部激情电影	色情
操操Gm	色情
鳥g M	色情
娱乐性大型黄站	色情
勞+教+所	色情
反日活动	色情
104bb成人小电影	色情
大鸡吧插meimei淫屄	色情
林心如做爱网有激情	色情
┓	色情
陈慧琳精品	色情
老土	色情
┯	色情
邓颖超	色情
國家機密	色情
温馨提示	色情
毛生鸦片	色情
大鸡巴狠狠插进了她那又肥又嫩的小骚屄儿	色情
插的jiejie好爽	色情
往事追忆录	色情
習近平	色情
毛李洪志	色情
马三家	色情
fuck私\服	色情
操插gm	色情
淫毛	色情
大鸡巴插进她肉洞里	色情
游戏蜗牛	色情
4-Jun	色情
册老	色情
本拉登	色情
毛迷魂药	色情
激情淫穴影院	色情
應召	色情
圣母	色情
tESt	色情
少妇房中自淫，和两勇男玩14P，操得直叫爽 操日本淫女穴	色情
開天	色情
鸡八	色情
骑士	色情
奶挺臀翘	色情
激情色	色情
六岁幼女阴穴近拍	色情
國務院	色情
插淫女小穴	色情
敬國神社	色情
mo jian	色情
发$$轮	色情
101bb成人小电影	色情
最淫熟女网	色情
妓	色情
爱的乱伦	色情
騷B賤	色情
插在妈妈嫩嫩的小肉穴	色情
激情成人电影	色情
毛阝月	色情
24dy淫色贴图	色情
欢乐时代	色情
銷魂洞	色情
rxjhhvip	色情
法^^沦	色情
慈善会	色情
毛你老味	色情
性感妖嬈	色情
机巴	色情
铁甲争雄	色情
阴囊	色情
abc abc	色情
呆比	色情
综联数码	色情
成人联盟	色情
系統	色情
ＧＡＭＥＭＡＳＴＥＲ	色情
妻子小穴	色情
Bc	色情
制服美婦	色情
ｌｏｎｇ ｈｕｎ	色情
厕所性感美女清晰淫穴	色情
毛黑手党	色情
runstar	色情
免费成人图片 色情meinv做爱meinv小穴写真	色情
李瑞环	色情
两性小说	色情
东北xx网	色情
刀剑	色情
少妇淫心我要看淫心	色情
免费视讯妹妹	色情
鮑嶽橋	色情
金庸群侠传	色情
ｈａｉ ｄａｏ ｓｈｉ ｄａｉ	色情
fuckyou	色情
小姨子的小嫩屄	色情
san guo ce	色情
挂机	色情
瀬咲るな	色情
毛外专局	色情
处女穴 阴唇 肉缝	色情
激情成人淫片	色情
干妈妈的爽	色情
他母亲	色情
華夏II Online	色情
ｍｏ ｆａ ｆｅｉ ｑｉｕ	色情
情色导航	色情
张萬年	色情
妹妹的大阴户	色情
人民	色情
cdjp李鵬*	色情
發論	色情
徐才厚	色情
成人图库，操女人穴，色情贴图，性交贴图，操ＭＭ穴，超级淫图	色情
成人激情电影通道	色情
智能H3	色情
娼妓	色情
欠日	色情
毛小泉纯一郎	色情
嗎個	色情
嚴雋琪	色情
經典炮圖	色情
日你爸	色情
欠干	色情
meimei的嫩屄	色情
柯赐海	色情
鞭神	色情
毛独立台湾会	色情
綜聯數碼	色情
色网阴道特写强奸35岁处女全过程	色情
台湾男女激情淫乱小说	色情
89暴亂	色情
毛王刚	色情
毛干你娘	色情
那娘老比	色情
好……小……小骚穴	色情
淫液顺着肉棒	色情
錢其琛	色情
ａｉ滋	色情
∪R靠	色情
性奴會	色情
阴唇阴道大图三级	色情
小穴不断被顶入	色情
赤裸	色情
淫荡家族群体性交	色情
KISS	色情
学生爱国者运动	色情
乳晕	色情
喔┅┅我又要泄┅┅泄了	色情
欧美乱淫贴图	色情
行房	色情
雞8	色情
列宁	色情
淫民激情文学图库下载淫民激情文学图库专题	色情
台联	色情
fuck系统	色情
聚友網路	色情
恥辱醫護	色情
激情淫色文章	色情
转法轮	色情
遺囑	色情
淫乱小穴	色情
二乙基酰胺	色情
┧	色情
repent	色情
新義安	色情
他媽	色情
母女雙飛	色情
姦淫未成年的小女护士	色情
媽祖	色情
伊斯蘭	色情
祭日	色情
fuck王刚	色情
發*淪	色情
幹比	色情
粗硬大肉棍… 抽动…好舒服	色情
肉棒好大啊	色情
肉棒插入meinv的肉缝	色情
烂屄	色情
毛粮食局	色情
双龙入洞	色情
成人激情视频聊天室秘密入口	色情
和親jiejie作愛	色情
最淫大陆成人贴图电影区 处女一丝不挂自慰图片	色情
两片暗紅的陰唇一張一合	色情
fuck食屎	色情
张林	色情
抽插41岁处女妹妹淫叫不断	色情
私#服	色情
女人	色情
毛卖淫	色情
mo huan sen lin	色情
祁建	色情
┦	色情
舆论反制	色情
抽插45岁处女meimei淫叫不断	色情
毛卖软件	色情
姐弟乱轮 yy玛雅激情贴	色情
蒂巴因	色情
毛靠你妈	色情
性愛 圖庫	色情
登 輝	色情
賓館女郎	色情
严家祺	色情
基督	色情
美乳	色情
ｓｅａｌｏｎｌｉｎｅ	色情
ｗａｉｇｕａ	色情
下载免费淫电影淫穴流	色情
艷照門	色情
ｄａ ｈｕａ ｚｈａｎ ｇｕｏ	色情
车臣	色情
成人情色论坛导航	色情
宫泽Keito无修正第二弹	色情
a 片成人免费激情小电影	色情
龟头对准菊门	色情
干啦	色情
成人激情图库	色情
fuck天鹅之旅	色情
中国复兴论坛	色情
花花公子	色情
phuck	色情
鑫诺	色情
少妇的骚穴淫液	色情
毛干妳娘	色情
無碼做愛	色情
哥哥淫奸妹妹论坛	色情
龟头抽插很紧的处女阴道	色情
女儿的阴道好大啊	色情
東北xx網	色情
有容奶大	色情
台湾午夜色情	色情
程铁军	色情
舌頭穴	色情
奇侠XIAH	色情
外教上课迟到就挨操	色情
弟大勿勃	色情
KAO	色情
免费淫电影网址大全	色情
盗电	色情
成人激情淫洞网站	色情
meinv嫂子的小骚逼	色情
39CK	色情
出售账号	色情
轮公	色情
宁王府成人导航	色情
处女小穴	色情
fuck骚	色情
jue dui nv shen	色情
北京xx网	色情
鸡巴猛插	色情
法$掄	色情
┒	色情
姐姐的穴好紧啊	色情
qb	色情
毛穆罕默德	色情
劲舞世界	色情
生奸内射	色情
手记注册日韩5008部激情电影	色情
手指扒开红嫩的阴唇	色情
我日你	色情
毛石进	色情
淫女淫洞	色情
牙齿轻咬着阴核	色情
亲民党	色情
朝倉Riho ！【RMVB/405MB】	色情
日本av女优	色情
GCD	色情
儿子的大肉棒	色情
日他娘	色情
广东王	色情
性情	色情
那嗎B	色情
下賤	色情
鸡吧勃起插入阴道	色情
系統訊息	色情
猛烈 挺送 肉棒 激烈 撞击	色情
无界浏览	色情
免费成人情色激情视频聊天	色情
偷欢	色情
高校骚乱	色情
子宫口吮吸着龟头	色情
发~~论	色情
操Gm	色情
發~侖	色情
ｘｉ ｙｏｕ ｆｕ ｍｏ ｌｕ	色情
亚洲成人贴图区论坛	色情
天鹅绒活动	色情
江賊民	色情
小穴夹的我好紧	色情
ｊｉｎ ｗｕ ｓｈｉ ｊｉｅ	色情
迷奸	色情
狗娘养的	色情
毛塞你母	色情
用舌尖插着阴道口	色情
政协	色情
夫妇乐园	色情
肉洞 肉棒 肉缝	色情
幾芭	色情
车牌反光	色情
毛工力	色情
上妳	色情
大使馆	色情
法$$綸	色情
SEX	色情
色情电影 免费电影 成人影院	色情
兔妹妹色色贴图区	色情
踢	色情
阴道图片	色情
色网阴道特写强奸20岁处女全过程	色情
你的逼……真紧	色情
Tokyo Hot n0248 菊池奈津美 本物RQ体内汁注入22连发六月联	色情
(ATHENA)奥様欲情日記 エプロンをめくって犯して うずく人妻美巨乳スペシャル	色情
urban-rivals靠	色情
黄色做爱电影	色情
陆肆	色情
去妳的	色情
插阴茎	色情
高橋英4套片合共	色情
xyj	色情
奴事件	色情
淫虫电影	色情
凯丰	色情
胡耀邦	色情
干爹的龟头	色情
车仑女干	色情
乳暈	色情
媽個B	色情
賣逼	色情
烂	色情
淫*女电影片段试看淫mm	色情
无码电影	色情
姐姐的肥阴唇	色情
毛看牌器	色情
淫荡痴女贴图	色情
大東亞共榮	色情
黄菊	色情
dao jian	色情
免费淫色情电影 欢迎点击进入观看/林/心如/20岁处女偷拍/免费A。B片	色情
淫女淫图淫书淫片	色情
周恩來	色情
谢中之	色情
王 冶 坪	色情
插入妹妹穴中	色情
红 灯 区	色情
ttwg666	色情
激情淫文章	色情
性感动感美女日本幼少女性感写真	色情
抽插32岁处女妹妹淫叫不断	色情
fuck台联	色情
走私	色情
操完姐妹操嫂嫂	色情
又鳥女幹	色情
發@輪	色情
內褲	色情
╄	色情
来干	色情
裙内偷拍	色情
抽插23岁处女妹妹淫叫不断	色情
朱德	色情
胡緊掏	色情
毛傻吊	色情
极品激情影院	色情
屍體	色情
flyfff	色情
毛卖国	色情
菜逼	色情
鸡巴顶开花瓣	色情
明星捐款	色情
本站10015多部激情电影全部免费试看	色情
da tang hao xia	色情
吴 官 正	色情
怎样延迟射精20岁以下禁	色情
海盜王ONLINE	色情
侬着卵抛	色情
超级淫图	色情
毛枪决女犯	色情
雞吧 阴茎 插 騷穴 嫩穴 小穴	色情
开粉红小阴唇	色情
省长	色情
教你怎样延迟射精23岁以下禁免费淫电影a片	色情
法$$侖	色情
依星	色情
毛卫生部	色情
肉棒插进美穴	色情
射了还说要	色情
项怀诚	色情
妹妹张开双腿等你操	色情
ｊｉａｏｃｈｕｎ	色情
操草的你妈	色情
毛彭真	色情
日本淫色贴图	色情
日你	色情
淫术炼金士	色情
俞正声	色情
大……鸡巴……操得……很……很……舒服	色情
48xp。com 电影免费	色情
da hua chun qiu	色情
成人激情淫网站	色情
和两勇男玩27P	色情
梁保华	色情
广电	色情
毛海关总署	色情
肉棒插入又大又深的穴	色情
陽痿	色情
悔过书	色情
本站10013多部激情电影全部免费试看	色情
中国民主党	色情
淫	色情
精童欲女	色情
老二在她湿润的阴道口边摩擦	色情
乱伦父女	色情
shyt	色情
博讯	色情
叶剑英	色情
強暴	色情
毛天安门	色情
Tora-Tora-Tora Platinum Vol。9 Runa Mikami	色情
毛反恐委员会	色情
张伟华	色情
練完瑜伽功做？才爽呢(國產3p)	色情
郝建秀	色情
以茎至洞	色情
独立台湾会	色情
老騷比	色情
徐建國案件	色情
正邪大决战	色情
六四屠殺	色情
学习班	色情
拉凳	色情
现金	色情
東京熱最受歡迎長腿美女~藤澤安奈~腿長人又漂亮	色情
国产AV	色情
双飞+毒龙直到分享了精液	色情
人學生meimei 埼玉援交 vol。2 なな＆まい	色情
卖卡	色情
法@淪	色情
大逼	色情
買月卡	色情
做爱淫图	色情
阳精	色情
piao liu huan jing	色情
女卫生间盗摄图	色情
操成人电影	色情
一邊一國	色情
香港激情图源成人色情论坛脱衣美女做爱	色情
露出了娇小鲜嫩的阴道	色情
十六大	色情
免费成人聊天室	色情
阿姨的阴唇好大啊	色情
迷姦雙胞妹妹	色情
圣角色扮演学园	色情
八九	色情
和妈妈玩插穴	色情
制服美少女 鮎川なお	色情
六-四	色情
免费小淫虫	色情
asshole asshole	色情
电影试看片	色情
勾魂少婦	色情
痴女吸精	色情
中蕐	色情
遗精	色情
一夜情交友	色情
插穴	色情
江择民	色情
12岁处女开包现场	色情
ｓｐｅｃｉａｌｆｏｒｃｅ	色情
毛吗啡	色情
色meimei大型黄站	色情
夜聊视频聊天室	色情
跑跑	色情
发$$伦	色情
meimei的淫穴被龟头顶住	色情
漏逼	色情
激情淫色贴图导航	色情
让我的肉棒缓缓的插进潮湿饥饿的娇嫩的肉洞里	色情
小雞雞	色情
无网界浏览	色情
55sss偷拍區	色情
性电影免费在线试看	色情
蒋震文	色情
肏又嫩又紧的穴	色情
成人漫畫	色情
ｌｕａｎ ｓｈｉ ｓａｎ ｇｕｏ	色情
transsexuell	色情
新疆獨立	色情
弟弟淫奸姐姐穴	色情
hongzhi	色情
免费淫奸女Ａ片段试看	色情
性感美女淫穴	色情
18岁少女处夜激情性爱电影	色情
龟头插入淫荡少妇	色情
抽插46岁处女meimei淫叫不断	色情
kuaik	色情
絲襪美腿、痴女、女同	色情
成人圖片	色情
淫水	色情
胡緊套	色情
AV-熟女 五十路 -故知新　-藤由美 53-	色情
猛舔她的肥穴	色情
亚洲meinv	色情
又肥又大的骚屄儿	色情
抽头	色情
法~~論	色情
江核心	色情
眯眯爱大型黄站	色情
肉棒捅入阴道里	色情
两个中国	色情
蜜洞	色情
嫂嫂淫穴	色情
乳房 小穴 鸡巴	色情
手记注册日韩5026部激情电影	色情
淫流	色情
FUCKYOU	色情
倒台	色情
红楼美穴肛交淫图	色情
大陆激情淫穴小说	色情
哥哥使劲插我	色情
胡景涛	色情
大中国论坛	色情
插gm	色情
ｆｅｎｇ ｗｕ ｔｉａｎ ｊｉａｏ	色情
陳宗興	色情
干妹妹小穴	色情
８８科技	色情
哦……再快……小屄要美死丁……	色情
超英赶美	色情
西藏問題	色情
手分开嫩肉缝	色情
颜射自拍	色情
QQ音速	色情
ｓｎｋ。ｎｉ8。ｎｅｔ	色情
共党	色情
操操你八辈祖宗	色情
看高潮屋	色情
和meimei做爱	色情
和两勇男玩49P	色情
色情 激情 淫乱 卡通 高潮	色情
天畅	色情
劉傑	色情
droiyan	色情
铀	色情
幹死	色情
无码彩图	色情
法@@沦	色情
免费淫电影吴宗宪搞笑语录(21禁看)	色情
唐捷	色情
大鸡巴在她的小嘴抽送	色情
下载免费黄色淫乱电影	色情
淫meimei成人情色论坛	色情
看完保证你打飞机免费电影网站	色情
狗屁	色情
淫荡女护士	色情
爽你	色情
百家乐	色情
气象局	色情
毛你姥姥的	色情
做鸭	色情
阝月	色情
二B   帝國	色情
午夜淫电影	色情
狂操空姐	色情
東方傳說online	色情
免费淫色情电影 处女第一次阴道做爱全过程(全套图片)	色情
華建敏	色情
俞正聲	色情
鸡巴全根没入 阴道	色情
homosexuel	色情
…用力干…嫩穴紧插	色情
情色導航	色情
奸淫……好舒服	色情
毛淫贱	色情
台湾建国运动组织	色情
开天	色情
meimei的阴道真紧	色情
色魔堂电影论坛	色情
航海世紀	色情
毛反动	色情
知障	色情
套子	色情
卡斯特罗	色情
曾慶紅	色情
淫色搔女网	色情
大 中 國 論 壇	色情
配合着蜜洞内肉棒的抽插	色情
骚b熟女	色情
你妈的	色情
拐卖	色情
骚棒	色情
刘淇	色情
台湾共产党	色情
精液射进小姨的子宫	色情
天天任我淫	色情
Offgamers	色情
xi you fu mo lu	色情
龟头操进处女阴道	色情
┡	色情
乱伦禁书	色情
ｘｉｎ ｍｏ ｊｉｅ	色情
电监会	色情
足球經理線上	色情
轮暴	色情
测試员	色情
快克	色情
淫色论坛	色情
毛XX	色情
全球公審江澤民	色情
ｄｅｋａｒｏｎ	色情
咪咪情色	色情
生孩子没屁眼	色情
sm調教	色情
操濫妳那騷穴	色情
騰武	色情
曲线消魂	色情
塞你老师	色情
neosteam	色情
毛你妈的	色情
幹妳	色情
淫水翻騰	色情
毛民运	色情
法~~轮	色情
爱爱激情电影	色情
胡紧掏	色情
寇晓伟	色情
紮卡維是英雄	色情
运營者	色情
admin	色情
女马	色情
Itsuka_part2	色情
毛法(轮)功	色情
赖昌星	色情
万淫堂	色情
ｂｉａｏ子	色情
操操蛋	色情
白立朴	色情
王志珍	色情
petgirl	色情
成人性爱视频 电影 聊天室	色情
ｑｑ堂	色情
人 民 内 情 真 相	色情
ｋ粉	色情
89六四	色情
毛游戏宫理员	色情
江西田园置业集团	色情
法$$輪	色情
蕩女	色情
科洛斯	色情
幹	色情
塞你爸	色情
李铁映	色情
最强美乳初解禁	色情
虎虎虎~ Tora-Tora Platinum Vol。2 : 魔性的meinv 鈴木麻奈美	色情
毛一党专制	色情
法车仑工力	色情
操b	色情
学生爱国运动正名	色情
顶级乱伦高潮淫水	色情
ｅｖｅｒ ｑｕｅｓｔ	色情
ｈｅｌｌｇａｔｅ:ｌｏｎｄｏｎ	色情
康生	色情
淫奸妹妹的屄	色情
青天白日旗	色情
美女淫色贴图区	色情
罢餐	色情
李 嵐 清	色情
周贺	色情
fuck私服	色情
免费淫电影吴宗宪搞笑语录(27禁看)	色情
包pi	色情
fuck社会主义	色情
毛外　挂	色情
ｄｉｇｉｍａｇｉｃｓ	色情
毛阳精	色情
民为法执	色情
国民党万岁	色情
萬淫堂	色情
在线观看淫电影	色情
可怜卖菜妇	色情
无码无套	色情
北京之春	色情
色mm激情论坛	色情
马巧珍	色情
ttee	色情
核潜艇	色情
appie	色情
蜜穴被阴茎插入	色情
狂操你全家	色情
a4u	色情
屁精	色情
塞你老母	色情
測试員	色情
肥穴jiejie	色情
陳希同	色情
奸一奸	色情
fuck他妈的	色情
狗操卖逼	色情
抽插56岁处女妹妹淫叫不断	色情
jiejie的穴夹的我好紧小说	色情
抽插20岁处女meimei淫叫不断	色情
倚天	色情
李 旺 陽	色情
激情网站地址	色情
裝備展示	色情
淫乱的女老板	色情
奸她	色情
ｓｈｅｎｇ ｚｈｅ ｗｕ ｄｉ	色情
李志绥	色情
fuck网管	色情
明星淫圖	色情
干比	色情
吮吸小穴	色情
狂插日本学生妹	色情
法陯功	色情
催情药	色情
89學潮	色情
于幼军	色情
淫奸meimei电影	色情
婚外戀	色情
淫电影//教你怎样延迟射精18岁以下禁免费淫电影a片	色情
黄  菊	色情
狂插美女老师	色情
毛江核心	色情
哥哥用力舒服死我吧	色情
免费淫电影吴宗宪搞笑语录(24禁看)	色情
淫奸护士姐姐穴	色情
川岛芳子	色情
妹妹淫水 流	色情
makelove	色情
硕大的肉棒	色情
未满21岁的请自行离开 ！	色情
免费淫电影，看完保证你打飞机	色情
作爱	色情
桃色星期五	色情
强奸17岁处女全过程/*妹阴毛小穴	色情
舔舔私处妹妹嗷嗷叫	色情
三八淫	色情
情色导航色情排行榜大陆黄网导航免费成人电影	色情
美女嫩穴 妹穴 亮穴 女人穴	色情
淫穴摩擦龟头	色情
欠人骑	色情
吕京花	色情
發倫	色情
干空姐小穴	色情
冈村宁次	色情
VULVA	色情
成人午夜场影院	色情
下贱	色情
臺湾國	色情
十年動亂	色情
处女膜	色情
和两勇男玩45P	色情
jiejie的阴道好嫩啊	色情
亂倫熟女網	色情
亚历山大	色情
反党	色情
狂插 肥穴	色情
激情潮喷	色情
SOD 厳选!残虐レイプ集	色情
几芭	色情
chuang shi ji	色情
小b	色情
六合采	色情
干拎娘	色情
嫂嫂的穴	色情
九霾	色情
法@论	色情
和两勇男玩28P	色情
美女孩含双棍玩内射	色情
軍妓	色情
达尔富尔	色情
受虐狂	色情
蒙古独	色情
广电局	色情
免费淫奸女A片	色情
淫语痴女	色情
女学生拍我该死	色情
插入 嫩穴	色情
18禁-空中小姐的淫荡性生活(无码)。	色情
李兰菊	色情
ｘｉｎ ｃｈａｎｇ ｚｈｉ ｙｅ ｗａｎｇ	色情
鹿城黄站百家性	色情
色情成人网站	色情
激情淫色故事	色情
┇	色情
屁股	色情
运營組	色情
淫meimei成人娱乐	色情
发~~轮	色情
kang zhan	色情
發@淪	色情
久遊	色情
洞洞淫水清晰大图	色情
玉乳	色情
薄一波	色情
白嫩丰腴的大腿掰开成大字形，肥嫩的小骚屄儿	色情
4f	色情
不爽不要钱	色情
吸精小少女	色情
和两勇男玩24P	色情
鸡巴深深地插在妈的阴户里	色情
长长的肉棒插进我的阴道里	色情
暴政	色情
美女发春激情在线电影	色情
爽图网	色情
fuck外交部	色情
届中央政治局委员	色情
无套肉棒浓稠内射漂亮屄	色情
平可夫	色情
小平	色情
ctracer	色情
大力抽送	色情
Asian Hot 018 岸田香織 女陰破壊	色情
法*侖	色情
大鸡巴用力的往小穴里面狠插	色情
青樓	色情
梦幻西游	色情
fuck神经病	色情
林果	色情
个人资料	色情
chong wu wang	色情
民政部	色情
浪女自慰诱惑你操	色情
日本淫荡妹妹	色情
50xp。com 电影免费	色情
27dy淫色贴图	色情
伱妈	色情
露乳	色情
免费a片	色情
欢乐数码	色情
淫奸女图片	色情
黄色免费电影美女	色情
苏家屯	色情
誅仙	色情
情色电影立即看	色情
毛后庭	色情
陰道圖片	色情
唐人互動	色情
毛托管理事会	色情
Tora-Tora Platinum Vol。11 S级圣女 持田茜	色情
新闻管制	色情
阳具在他的穴里大幅抽插	色情
国权	色情
海盗王	色情
强奸系列精品	色情
漢奸	色情
毛文化部	色情
轮奸做爱高潮录象	色情
被干	色情
龟头碰到子宫口	色情
海之乐章	色情
它妈	色情
毛妹妹淫色	色情
苯环已呱啶	色情
BT激情	色情
鋼管舞	色情
夢~ Pure Idol Vol。 20 : 望月なな	色情
网游久久金币	色情
d7se我淫我电影	色情
裸體少婦	色情
花瓣正在潺潺地渗出蜜汁	色情
倚天屠龙别记	色情
baichi	色情
无产阶级	色情
婷婷淫女小说	色情
meinv	色情
荡母淫儿	色情
日gm	色情
淫亂軍團	色情
三国策	色情
隐窝窝	色情
猛男狂干meinv	色情
干林	色情
毛东突暴动和独立	色情
又粗又硬的大肉棒	色情
吴方城	色情
粮食局	色情
战场	色情
贱种	色情
新疆独	色情
语句	色情
余震	色情
何 德 普	色情
现场强奸18岁处女扒开小穴清晰做爱阴道裸体图	色情
GAME	色情
綿陽	色情
偷歡	色情
白粉	色情
神泣	色情
外_掛	色情
世紀天成	色情
吃鸡巴	色情
把肉茎抽出插入屁眼里	色情
肉棒在jiejie的阴道里	色情
金城安娜-痴女教官NO。7	色情
谭政	色情
【亚洲/无码】极品女优-姬野愛！【RMVB/488MB】	色情
女屄	色情
台湾青年独立联盟	色情
用力操舒服死我吧	色情
大众成人网	色情
王冶坪	色情
銀行帳號	色情
性交内射	色情
美女下体淫水直流	色情
搜狐	色情
午夜性爱惊魂	色情
奸你	色情
妹妹　MM激情	色情
干gm	色情
新聞管制	色情
和两勇男玩31P	色情
ｔｉａｎ ｙｉ ｚｈｉ ｌｉａｎ	色情
ㄙㄞ你娘	色情
巨大的鸡巴戳了进去	色情
绵阳	色情
色狼俱乐部	色情
香港免费黄色淫乱电影	色情
吃精	色情
罗  干	色情
onewg	色情
免费妹妹黄色淫乱电影	色情
bedclip。com	色情
顶进她的花蕊	色情
床上的淫荡少女	色情
mm电影小片段试看免费淫影片	色情
吴仁华	色情
毛强奸	色情
骚逼小姨	色情
騷貨	色情
操操逼	色情
欧美成人贴图区	色情
外*掛	色情
yuanmingxinsheng	色情
非典	色情
亚洲午夜成人影院中心	色情
亂倫	色情
淫妹妹成人情色论坛	色情
本站10018多部激情电影全部免费试看三天	色情
毛滚	色情
欧美激情淫电影	色情
fuck卖．国	色情
手记注册日韩5007部激情电影	色情
PP一点通 - 成人电影	色情
于浩成	色情
发~论	色情
VIP激情成人电影	色情
wgpj	色情
欠骑	色情
幹你媽b	色情
顏射	色情
蔣樹聲	色情
賴昌星	色情
毛三陪	色情
梅毒	色情
台幣	色情
肉棒放在阴道口	色情
Wg	色情
初二辣妹	色情
发^仑	色情
西藏喇嘛	色情
插入穴 爽	色情
hrichina	色情
軍民血腥衝突	色情
wowbank	色情
溫 元 凱	色情
┃	色情
Lady Sonia-熟女絲襪 3	色情
ｈｕａｎ ｌｉｎｇ ｙｏｕ ｘｉａ	色情
骚批	色情
烂B	色情
龟头用力刺入阴道	色情
妳馬的	色情
迷药	色情
┛	色情
骚姐乱伦网	色情
helper	色情
933cn	色情
鸠屎	色情
極品白虎	色情
hai tian ying xiong zhuan	色情
男人阁-套图站	色情
ha bao	色情
黄片	色情
亲亲小芳 色咪咪论坛 新亲密爱 六月龙盟 人间仙境情色网	色情
乳腺	色情
信不信我撞死你	色情
台湾独	色情
国民政府	色情
发@仑	色情
情色淫电影	色情
操赤匪	色情
CAO NI MA	色情
好嫩的阴户	色情
痴乳	色情
日韩妹妹嫩穴淫图	色情
xi you	色情
摇頭丸	色情
达赖喇嘛	色情
whoyo	色情
美女主持27小时全天激情热舞	色情
册那娘饿比	色情
王兆國	色情
儿子顶到jiejie的花心	色情
Yukata Angel Vol。 1 : 矢崎茜	色情
誘姦	色情
法$轮	色情
自由之门	色情
代練	色情
18dy村妓	色情
亚洲	色情
中國成人論壇	色情
免费淫电影 看完保证你打飞机	色情
脸盘美身材好就是屄丑点	色情
肉棒插进子宫了	色情
外卦	色情
淫荡妈妈骚姊姊	色情
肖强	色情
毛鸦片	色情
亚洲乱伦之淫穴	色情
手伸到儿媳妇下体抚摸嫩穴	色情
欧美两性淫乱	色情
狂操	色情
狗养	色情
操你媽	色情
操穴喷水	色情
法论	色情
红楼绮梦	色情
こどもの时间VOL。1-7	色情
激情玩淫穴电影	色情
毛信息产业部	色情
统战	色情
成人电影网	色情
fuck世界日报	色情
插 穴 射 喷 精液	色情
外  挂	色情
Chudi Chudi	色情
法论公	色情
賤人	色情
伊朗	色情
抽插37岁处女meimei淫叫不断	色情
赵 晓 微	色情
黄色免费淫乱电影	色情
ㄖ	色情
ㄐ巴	色情
小卵子	色情
操肿	色情
插小穴妹妹直流水	色情
bo ke	色情
插陰	色情
wG	色情
抽插18岁处女妹妹淫叫不断	色情
信号拦截器	色情
法**淪	色情
江流氓	色情
ｓｏｎ ｏｆ ｂｉｔｃｈ	色情
小骚逼	色情
母子交歡	色情
懶教	色情
国研室	色情
中國	色情
日本騷貨	色情
和阿姨作爱	色情
午夜免费爽电影	色情
和两勇男玩46P	色情
体育总局	色情
胡锦淘	色情
魔獸幣	色情
捅进她的阴道里	色情
效忠天皇	色情
清秀巨乳学妹校园内被轮奸	色情
妈个比	色情
ｂａｔａｒｄ	色情
毛乳房	色情
gcd	色情
放荡	色情
疯狂抽插嫩穴	色情
国际足坛五大	色情
慰春情	色情
毛官商勾结	色情
Angel Cosplay Vol。 2 新村爱加贺美由贵	色情
中国和平	色情
好紧的穴	色情
妈逼靠	色情
幹你娘	色情
插meimei淫屄	色情
Heterosexual	色情
新华社	色情
中国大型免费成人黄色图片区	色情
百家性大型黄站meimei	色情
黄金圣水	色情
淫女床上的自慰	色情
本站10009多部激情电影全部免费试看三天	色情
手指对她阴蒂的刺激	色情
华义	色情
毛色情小电影	色情
U-R靠	色情
中國政府	色情
毛人民日报	色情
吗比	色情
紫黛	色情
阎王	色情
肉棒就顺着湿滑的阴道口插进去了一半	色情
屠杀	色情
我日靠	色情
龟头在她的阴道里抽插	色情
嫩穴 肉棒 肉缝	色情
农村公公与媳妇乱伦	色情
姜春云	色情
毛洗脑班	色情
淫色俱乐部	色情
打飛機	色情
日Gm	色情
泄密	色情
狗干	色情
毛可待因	色情
钱 其 琛	色情
粗大的龟头缓缓磨擦着湿漉漉的阴户	色情
八九学潮	色情
濕了還說要	色情
征途	色情
易当	色情
免费激情网	色情
杨勇	色情
发伦	色情
大 史 纪	色情
做ai	色情
大鸡巴干进妹妹的小穴	色情
发**伦	色情
国家总理	色情
鲜族	色情
聂荣臻	色情
免费在线看淫电影下载	色情
獨立臺灣會	色情
极品金牌素人口交系列	色情
爆乳美脚RQ中出し鬼輪姦-- 森高レナ	色情
北京当局	色情
不卡免费淫电影	色情
韩光	色情
风骚小护士	色情
共*党	色情
雪白的屁股对着肉棒	色情
外**掛	色情
统计局	色情
钢管舞	色情
pnisse	色情
naked naked	色情
毛温家保	色情
日本人	色情
封神榜	色情
日韩免费午夜电影	色情
秋本純菜	色情
蕩婦	色情
戒急用忍	色情
抽插淫水	色情
如果你未满22周岁请自觉离开。	色情
法×	色情
情色导航 成人电影	色情
大话春秋	色情
极品嫩穴 淫穴嫩穴 扒开嫩穴 抚摩她的嫩穴	色情
网爱	色情
坐庄	色情
情色ＢＴ	色情
香港淫穴裸体图	色情
NPC	色情
錘子	色情
百家性大型色	色情
a片/A片下载/毛片/毛片下载	色情
龟儿子	色情
发@@纶	色情
大跃进	色情
ｈｅｒｏ108	色情
龟头直抵子宫口	色情
手机注册看激情电影	色情
殺你一家	色情
日本卡通淫色动画片	色情
凌辱	色情
挑战	色情
色女	色情
东突暴动和独立	色情
射颜	色情
臀部	色情
qqr2	色情
毛西藏独立	色情
处女第一次阴道做爱全过程	色情
狂插meinv护士小说	色情
夹得我好舒服	色情
毛台办	色情
meng xiang	色情
淫荡小护士	色情
黑毛屄	色情
戴红	色情
18岁禁淫荡小处女	色情
ｃａｏｂ	色情
巨乳女优 千秋大合集	色情
狂插我的小嫩穴	色情
(虎虎虎)风间ゆみ-新婚	色情
少妇房中自淫，和两勇男玩3P，操得直叫爽 操日本淫女穴	色情
ｄｉ ｇｕｏ ｃｈｕａｎ ｑｉ	色情
银行账号	色情
阴户抽插	色情
sheng da fu weng	色情
ALERT	色情
毛信访局	色情
大鸡巴┅┅爽	色情
ｇａｔｅ ｔｏ ｈｅａｖｅｎｓ	色情
西藏独立	色情
日本meinv图库	色情
新语丝	色情
鳥Gm	色情
鹽酸二乙酰吗啡	色情
go-vern-ment	色情
婷婷淫色贴图	色情
亲 日	色情
免费观看女教師赤版	色情
我幹	色情
插小穴meimei直流水	色情
毛性交	色情
阳具	色情
新斷線	色情
成人bt	色情
肛jiao	色情
fuck西藏天葬	色情
又粗又长的肉棒插入阴道里	色情
激情四川方言版	色情
黄色激情论坛	色情
胸垫	色情
エロい女中出し20連発姫野愛	色情
摩洛客	色情
盛大富翁	色情
淫絲蕩襪	色情
体奸	色情
极品激情电影	色情
神婆	色情
18岁女生主动让男生开苞全过程◥免费黄色电影	色情
好弟弟使劲干姐姐	色情
人代会	色情
發^輪	色情
无码H漫	色情
湿润的花蕊	色情
丫头养的	色情
龟头插进了小穴	色情
教你怎样延迟射精18岁以下禁免费淫电影a片	色情
三极试看片	色情
五月天成人激情网站	色情
香港激情淫色贴图	色情
臺灣帝國	色情
外*挂	色情
广闻	色情
jiejie的小穴被大鸡巴插得好舒服哟	色情
黄色情挑艳情小说网骚meimei成人论坛	色情
她马的	色情
ｔｉｅ ｊｉａ ｚｈｅｎｇ ｘｉｏｎｇ	色情
龙 虎 门靠	色情
日本淫电影	色情
彈 劾	色情
李文斌	色情
讓你操	色情
天安门档案	色情
免费淫色论坛	色情
扬震	色情
阴道好紧	色情
天堂2	色情
法车仑功	色情
89風波	色情
教你怎样延迟射精	色情
上你	色情
老骚比	色情
金泽辰	色情
美女成人	色情
红色的小穴	色情
幹妳媽	色情
牛比	色情
私处	色情
TW	色情
日X妈	色情
transexual	色情
骚妇露逼	色情
变态~幼男插嫩屄	色情
毛干你妈b	色情
黄家骁	色情
发@纶	色情
网址情色成人大全	色情
sanguohx	色情
臭机	色情
红嫩的小肉穴	色情
小泉	色情
干的你	色情
妈妈挺动雪白的肥臀	色情
他爸爸	色情
李金华	色情
性愛插穴	色情
嗎的	色情
八九风波	色情
发**仑	色情
╉	色情
神汉	色情
胡乔木	色情
ｊｉａｏｃｈｕａｎｇ	色情
綠色灵数碼	色情
jiejie的穴好紧啊	色情
meimei黄站	色情
警匪一家	色情
三去仑功	色情
日死你	色情
时事论坛	色情
肉棒 乱伦 肉洞	色情
DICK	色情
杨林	色情
本站10013多部激情电影全部免费试看三天	色情
┅干的妈好爽	色情
外••挂	色情
操抽插	色情
共铲党	色情
插淫穴的快感	色情
激情视频聊天	色情
騷女叫春	色情
情色 信息	色情
fuck性爱	色情
宇明网	色情
混沌诀靠	色情
政治犯	色情
精童	色情
去死	色情
狂插空姐	色情
宋书元	色情
舔b	色情
幼香阁	色情
质检局	色情
日b	色情
DELETE	色情
完全自由注册看成人电影	色情
manager	色情
操她妈	色情
江则民	色情
毛妈祖	色情
彭珮雲	色情
插b	色情
色情视频聊天	色情
黄易群侠传	色情
qi ji shi jie	色情
风骚小女孩湿身露体	色情
快樂AV	色情
毛郭伯雄	色情
妈要吃你的肉棒	色情
日本激情淫穴片	色情
牛比靠	色情
開發	色情
姐都快被你搞死了！	色情
王从吾	色情
鸡吧插进	色情
發**論	色情
pangya	色情
日本激情漫画贴图	色情
学生妹	色情
烂鸟	色情
大陆淫乱meinv图图片	色情
邝锦文	色情
淫女穴	色情
金枪不倒	色情
共青團員	色情
星钻物语	色情
淫乱少妇	色情
欧美淫乱美女论坛 清晰的窥阴图	色情
pussy	色情
张 钢	色情
G M	色情
李月月鸟	色情
无须注册淫奸小电影 图片	色情
激情淫乱图片穴欧美男人淫色贴图	色情
meinv主持脱衣	色情
朱勝文	色情
买春	色情
CS	色情
教你怎样延迟射精31岁以下禁免费淫电影a片	色情
毛干死你	色情
毛台湾共和国	色情
淩辱	色情
毛去死	色情
免费淫女骚穴在线看电影	色情
嫖娼	色情
操妳	色情
國產嫖娼	色情
help	色情
306医院	色情
私\服	色情
被幹	色情
插 12p	色情
毛傅作义	色情
狂操小穴	色情
滥逼	色情
人體攝影	色情
大陆淫乱美女图图片	色情
毛鮑	色情
中文搜性網	色情
建设部	色情
媽B	色情
System	色情
毛你老母	色情
小姨和我淫BB小说	色情
Gold Angel Vol。7 Super Erotic Girl : Ran Monbu 紋舞らん	色情
完美国际	色情
毛徐光春	色情
分裂国家	色情
賣B發論公	色情
吴官正	色情
16大	色情
情色俱乐部美女奸淫。黄色电影裸体电影PP点点激情电影	色情
毛你娘	色情
扒光	色情
meteor academy	色情
三個代表	色情
东土耳其斯坦	色情
添 穴 两腿间	色情
小穴被阴茎插的好痛	色情
成人激情	色情
手记注册日韩5030部激情电影	色情
毛晚年周恩来	色情
快插吧!┅┅快┅┅	色情
风雨神州论坛	色情
裸体贴图香港成人电影网	色情
操你爸	色情
贞操	色情
極景	色情
滝沢优季 Prisoner Of Love绝爱的监禁牢狱	色情
桃園蜜洞	色情
可憐賣菜婦	色情
SpecialForce	色情
奸淫电影	色情
恥辱醫護电影在线观看	色情
如果你未满31周岁请自觉离开。	色情
览叫	色情
外@@掛	色情
fuck唐家璇	色情
三级图片论坛禁自拍偷拍论坛日本黄色三级	色情
马克思	色情
溫加寶	色情
和两勇男玩11P	色情
meng huan zhi xing	色情
陳毅	色情
吸毒犯	色情
女做爱光盘亚洲	色情
淫肉誘惑	色情
内测帐号	色情
網星	色情
毛社会主义	色情
發~論	色情
黑手黨	色情
毛妈B	色情
本？拉登	色情
强奸34岁处女全过程/淫妹阴毛小穴	色情
狼友	色情
亚洲情色淫穴	色情
你的小穴好深啊	色情
法~~綸	色情
免费观看淫电影	色情
私￥服	色情
綸功	色情
大 紀元	色情
操财政部	色情
小骚屄儿meimei	色情
公告	色情
色色五月天	色情
日本淫虫在线看电影	色情
人民代表大會	色情
BIAOZI	色情
孤儿	色情
明星淫图	色情
高麗棒子	色情
吞精	色情
午夜电影	色情
毛倭寇	色情
兽欲	色情
1989事件	色情
外交论坛	色情
美女与猪性交电影	色情
K粉	色情
兩國論	色情
塞你娘	色情
bt 色情工厂	色情
妹妹骚图	色情
烂人	色情
操出售手枪	色情
用力扣进小穴	色情
肉棒顶的人家小穴好痒	色情
品色堂永远免费开放注册中	色情
delete	色情
Biaozi	色情
温州娱乐鹿城黄站	色情
日本免费激情学生美	色情
fuck卫生部	色情
不举	色情
6。4事件	色情
扒屄	色情
色网阴道特写强奸36岁处女全过程	色情
大龟头在花心深处	色情
六四動亂	色情
小穴┅┅好棒┅┅好爽	色情
毛抑制剂	色情
省長的兒媳婦	色情
你爺	色情
毛田纪云	色情
戀愛盒子OL	色情
毛私\服	色情
龟头已顺利挣开她紧合的阴唇	色情
少妇 淫穴	色情
赵 海 青	色情
透视眼镜	色情
塞白	色情
免费淫电影吴宗宪搞笑语录(26禁看)	色情
做愛	色情
買春	色情
贺国强	色情
G-M	色情
meimei吸精	色情
三唑仑	色情
unixbox	色情
毛发奖使者	色情
少妇被鸡吧操	色情
少妇淫图电影网	色情
中国分裂	色情
webgame。com。cn靠	色情
meimei的大阴户	色情
激情网址导航	色情
毛一贯道	色情
代炼	色情
毛妹妹贴图区	色情
激情淫色自拍	色情
ｚｈａｎｇ ｃｈａｎｇ	色情
新手指导员	色情
厉无畏	色情
毛鸡芭	色情
黑星女侠	色情
愛幼閣	色情
吸吮著我的阳具	色情
1989 事件	色情
淫电影 强*十八岁美女护士看完保证你打飞机	色情
六四以後	色情
隂	色情
qi shi	色情
淫荡护士穴	色情
紅火女郎~真央~壓倒性的震撼力~汙染女人的快感	色情
毛工商局	色情
大陆鹿城黄站	色情
装屄	色情
正悟网	色情
联国	色情
粗长的肉棒粉嫩的玉门里进出	色情
歡迎G8情色電影院	色情
法^倫	色情
Tora Tora Gold Vol。11 : 松田亜美	色情
ｗｕ ｌｉｎ ｗａｉ ｓｈｉ	色情
集体性爱	色情
共产主义	色情
免费在线淫电影网	色情
龟头挑逗花蕊嫩肉	色情
趙 曉 微	色情
处女性开苞 免费黄色淫乱电影bt下载试看	色情
骚meimei成人导航	色情
靓穴美女	色情
黄色免费电影	色情
fuck天安门一代	色情
强奸19岁处女全过程/*妹阴毛小穴	色情
fuck四川独立	色情
动漫激情淫色	色情
狂插日本美女护士	色情
六月四日	色情
吳儀	色情
男女激情淫乱穴下载	色情
大鸡巴 干进 小穴	色情
插阴	色情
苹果日报	色情
装B靠	色情
自由亚洲电台	色情
激情視頻	色情
无码体验	色情
正义党论坛	色情
jiang wang	色情
你她馬的	色情
母子淫奸乱轮现场看	色情
日屄	色情
李長春	色情
青天白日	色情
丁關根	色情
空姐护士淫荡图片 淫荡女护士 淫荡少妇穴	色情
美女插穴	色情
國家安全	色情
劲舞	色情
李先念	色情
tw	色情
ｓａｏｈｕａｏ	色情
王寶森	色情
操淫荡少妇穴 操淫荡妹妹穴 操淫荡姐姐穴	色情
亞無碼	色情
内测	色情
小鸡鸡	色情
一根材激情五月天	色情
盤古軟體	色情
色网联盟	色情
奥马尔	色情
saga	色情
肉穴	色情
性教育片－性教育电影	色情
爛B	色情
免費成人網站	色情
发@@沦	色情
鸡巴磨得舒服	色情
装逼靠	色情
操日风骚少妇穴	色情
国民党	色情
我和jiejie的淫乱史	色情
李 淑 嫻	色情
睾丸	色情
Red Hot Jam 9 ミュウの新人调教	色情
毛东亚病夫	色情
斷電	色情
黄色网站	色情
毛反日	色情
强奸25岁处女全过程/*妹阴毛小穴	色情
無界	色情
222se圖片	色情
小穴被插的好爽啊	色情
日本美女吃精图	色情
鄒家華	色情
on9	色情
干阿姨小穴	色情
毛妈卖妈屁	色情
三去車侖	色情
帶套肛交	色情
烫的大鸡巴在小穴里来回抽插	色情
出售假币	色情
奸夫淫妇	色情
开房	色情
sm调教	色情
乱伦	色情
龟头通过子宫口直抵花心	色情
多黨執政	色情
毛密洞	色情
毛共狗	色情
肉棒沾满了唾液	色情
五奶小青	色情
輪奸大美女	色情
ｘ到噴屎尿	色情
藏獨	色情
抽插	色情
美マンの極意 : 相原梨花	色情
不要！嗯──啊啊、啊啊！”	色情
新幹線	色情
騷媽	色情
人性本色	色情
萬稅	色情
淫水横溢	色情
mankind	色情
鸡女	色情
毛驶你娘	色情
免费黄色淫奸电影3级片a片手握着我的大鸡巴	色情
cnouc	色情
淫妻爱好者	色情
災區	色情
張筱雨	色情
國家分裂	色情
发论	色情
歪逼	色情
毛刘淇	色情
走资派	色情
李 岚 清	色情
台湾18岁成人	色情
麦克阿瑟	色情
台湾免费淫电影	色情
王剛	色情
反攻	色情
ｌａｔｅｉｎｏｓ	色情
国产av	色情
毛麻醉药	色情
卖逼	色情
┠	色情
93bb成人小电影	色情
插入她的搔B爽死了	色情
干你娘	色情
痴女護士	色情
郭 羅 基	色情
免注册淫色电影	色情
三级片	色情
安眠酮	色情
骚b	色情
俠客天下	色情
两性午夜激情电影	色情
八方链流量交换链	色情
一党	色情
法**掄	色情
试看片	色情
野外性交	色情
运营官	色情
痴女/淫乱 看護婦/女医 剃毛/パイパン！【AVI/723MB】	色情
毛学潮	色情
用力刺激小穴	色情
性交	色情
稀少罕见的美少女蝴蝶屄	色情
毛天安门屠杀	色情
└	色情
性宝贝淫色导航	色情
旅馆自拍	色情
wg8800	色情
慈善會	色情
王辅臣	色情
亚洲区人妖射精图最淫人体网站	色情
它爸爸	色情
18dy桃色	色情
胡锦濤	色情
粗挺的阴茎上沾满了处子的鲜血	色情
出墙红杏	色情
小B樣	色情
飞扬论坛	色情
ｘｉｎ ｊｕｅ ｄａｉ ｓｈｕａｎｇ ｊｉａｏ	色情
柯賜海	色情
ｐｏ ｔｉａｎ ｙｉ ｊｉａｎ	色情
曾庆红	色情
遗言	色情
hai dao wang	色情
他奶奶	色情
WEB战牌靠	色情
黑天使	色情
六四以前	色情
免费黄色电影	色情
色色	色情
切七	色情
三国演义	色情
李鵬	色情
和两勇男玩34P	色情
贱比	色情
卖淫女全过程	色情
搖头丸	色情
生鸦片	色情
操meimei	色情
司馬義？鐵力瓦爾地	色情
幼妓	色情
草的你媽	色情
陳奎元	色情
龟头在阴道中抽插	色情
肉棍狂插 阴精	色情
他ㄇㄉ	色情
激情淫穴小站	色情
RED HOT IDOL Vol。3 Concentrated Sex : 山咲舞 Mai Yamasaki 4	色情
和姐姐淫穴	色情
ｋｑｋｉｎｇ	色情
新人×ギリギ 七海	色情
她的小屄不紧	色情
法制办	色情
毛宋楚瑜	色情
卓奧	色情
胸濤乳浪	色情
TENGWU	色情
黑社会大姐大性欲很旺盛	色情
免费淫电影吴宗宪搞笑语录(28禁看)	色情
駛你老師	色情
毛死GD	色情
妈的骚穴 操 穴 逼	色情
playboy	色情
对著暴露的美穴狂插	色情
ｍｅｔｅｏｒ ａｃａｄｅｍｙ	色情
卖淫	色情
靈遊記	色情
最新黄站	色情
毛你妈逼	色情
坦克宝贝	色情
飙车	色情
meimei的小淫穴	色情
统独论坛	色情
楊振	色情
庆 红	色情
日本成人激情短片	色情
丁香社區	色情
如何推翻中共	色情
春城娱乐(淫窝)	色情
毛傻逼	色情
猛操狂射	色情
avi免费淫电影下载	色情
李登辉	色情
BT亚洲无码影片	色情
毛经社理事会	色情
淫虎成人导航	色情
张小平	色情
熟女護士亂舞	色情
乳此絲襪	色情
歡樂城	色情
毛迷歼药	色情
张 宏 堡	色情
情色成人基地	色情
丰盈雪白的肌肤、肥嫩饱满的乳房、红晕鲜嫩的小奶头	色情
强奸美女	色情
一本道~松下美里	色情
色區	色情
ｍｅｓ ｃｏｕｉｌｌｅｓ	色情
抽插37岁处女妹妹淫叫不断	色情
中俄边界	色情
dragon	色情
賣月卡	色情
处女第一次阴道做爱全过程(全套图片)免费淫电影a片	色情
Pure Idol Vol。20 望月なな ！【RMVB/543MB】	色情
劉曉竹	色情
成人漫画	色情
拔屄	色情
联众	色情
新生網	色情
免费meimei黄色淫乱电影	色情
成人色情网站	色情
一面打電話給現任男友	色情
爱巢滴水	色情
指点江山论坛	色情
webgame。com。cn	色情
淫情贴图	色情
毛射精	色情
qi ji	色情
发^^沦	色情
毛江折民	色情
老师的阴道好紧	色情
13点靠	色情
淫女乱搞免费三级片	色情
下流	色情
www。gpchina。com	色情
色聊人午夜激情聊天	色情
肉缝　嫩嫩	色情
保卫台湾	色情
大陆温州鹿城黄站	色情
廁所盜攝	色情
征服	色情
xyq	色情
布朗	色情
万王之王	色情
淫色贴图论坛	色情
热血英豪	色情
小穴被大鸡吧胀的好痒	色情
日本激情淫色动画片	色情
hypermart。net	色情
老少亂倫	色情
白嫩騷婦	色情
臺灣民國	色情
超级乐者	色情
免费成人图片	色情
喷	色情
免费淫色情电影 免费淫奸女Ａ片段试看	色情
性感肉丝	色情
dafa	色情
美体艳姿	色情
拳交	色情
肉棒插得湿润了	色情
带链	色情
毛巡查员	色情
賣卡	色情
和两勇男玩29P	色情
狗城	色情
塞你老師	色情
蔵獨	色情
做雞	色情
OLmeinv街上遥控震动A	色情
毛狗日的	色情
色聊激情视屏聊天室	色情
《金瓶梅》的巨著	色情
再奸	色情
毛傻屄	色情
淫民欧美激情贴图	色情
ｄａ ｔａｎｇ ｈａｏ ｘｉａ	色情
男女激情淫影片播放	色情
肉棒 用力 肉缝	色情
亚洲最大激情电影	色情
淫逼	色情
在线黄色电影	色情
魔性的meinv 鈴木麻奈美	色情
好硬的大肉棒	色情
强奸	色情
騷洞	色情
何德普	色情
毛人民	色情
毛新闻管制	色情
猛插林心如小穴	色情
我和姨在车上干	色情
黑省副省長	色情
臺灣	色情
Ninn Worx - Fem LAmour	色情
穴里嫩肉把鸡巴包得紧紧	色情
遊戲發獎員	色情
asshole	色情
柴玲	色情
ｔａｎｋｂｂ	色情
亚洲无码	色情
26dy淫色贴图	色情
杀你一家	色情
外~~掛	色情
免注册淫电影爱的色放	色情
白烂	色情
minghuinews	色情
八九風波	色情
色mm穴激情	色情
台湾小穴自拍护士做爱	色情
教养院	色情
安南	色情
世维会	色情
司馬義？鉄力瓦爾地	色情
海科数码	色情
情色图片成人小说	色情
抢劫	色情
毛鸡	色情
偷窥无罪	色情
温比	色情
ｈｕａｎ ｌｅ ｑｉａｎ ｓｈｕｉ ｔｉｎｇ	色情
你弄得阿姨爽死了	色情
卡通meinv淫色贴图	色情
┬	色情
一夜情异物插穴性爱网	色情
看着有点舍不得操	色情
操妹妹	色情
早泄	色情
ｅａｒｔｈｃｉｖ	色情
snatch	色情
olgad	色情
激情meinv贴图九九情色	色情
麥司卡林	色情
免费品嘗不倫主婦	色情
狂插学生妹	色情
性佣	色情
手记注册日韩5011部激情电影	色情
肉棍	色情
肉壁紧紧的包著龟头	色情
zlywy	色情
泡365免费电影	色情
毛发骚	色情
香港激情淫穴	色情
肏姐姐屄	色情
小骚洞 蜜穴	色情
操妳妈	色情
绿色数码	色情
臺灣建國	色情
激情淫女小穴	色情
统治	色情
da tang	色情
亦凡	色情
环保总局	色情
發輪	色情
王文京	色情
迷幻藥	色情
金鱗豈是池中物	色情
野鸡	色情
insert	色情
賣幣	色情
银行帳号	色情
metin	色情
san guo	色情
ｔｕｉ ｔｕｉ ｘｉａ	色情
軍國主義	色情
統治	色情
毒龍舔腳	色情
尻	色情
美丽素女の性游戏	色情
品色永远免费堂pin6 美女发春激情3级片试看	色情
狂插处女血流不止!	色情
卖党求荣	色情
嫩逼	色情
残废	色情
冰风传奇	色情
ｄａ ｑｉｎｇ ｄｉ ｇｕｏ	色情
lian ai he zi	色情
强奸25岁处女全过程/淫妹阴毛小穴	色情
常劲	色情
大鸡巴插进meimei的小穴	色情
ｓａｎ ｇｕｏ ｈａｏ ｘｉａ ｚｈｕａｎ	色情
Fku	色情
免费淫奸女Ａ片段试看 居然花钱请人教性爱姿势(组图)	色情
六四之後	色情
冉英	色情
我的穴	色情
毛外汇局	色情
肉壶	色情
18岁少女破处	色情
中共中央中华人民共和国	色情
两腿之间	色情
鲜红小嫩屄被群奸真可惜	色情
阴茎把子宫顶烂	色情
和两勇男玩32P	色情
狂插日本少妇	色情
欢欢娱乐时空	色情
来插我	色情
habbo	色情
劳+教+所	色情
本站10002多部激情电影全部免费试看三天	色情
他媽ㄉ王八蛋	色情
我和jiejie肏穴	色情
露穴	色情
免费视频裸聊	色情
十三點	色情
剛度	色情
陰穴新玩法	色情
血腥衝突	色情
宋庆龄	色情
BITCH	色情
肉棒小浪穴┅	色情
ｊ8	色情
他娘的	色情
hero	色情
丁香社区	色情
官人我要1	色情
你的大鸡巴好粗	色情
嫐屄	色情
毛你爷爷的	色情
av成人	色情
吸吮套弄了起来	色情
插妻子小穴	色情
阿弥陀佛	色情
客户服务人员	色情
做鸡	色情
AVW　FUCK　DOWN!最后性	色情
大阴唇jiejie	色情
嫩穴任我插 爽	色情
法^论	色情
巨乳護士南つかさ20連發中出	色情
毛发论功	色情
絲襪高跟	色情
發^^倫	色情
吸精痴女护士	色情
李 禄	色情
乱伦之淫骚穴	色情
豬操	色情
宏法	色情
ｓｅ中国	色情
毛鲜族	色情
wg666	色情
六四回憶錄	色情
少女bb图	色情
366成人网站	色情
乱伦熟睡的jiejie	色情
真主安拉	色情
台湾情色香港顶级淫片	色情
舔屄	色情
成人激情影院	色情
阳具在她的蜜穴里抽插	色情
民運	色情
掰开少女穴	色情
母子乱伦	色情
法仑公	色情
成人a片	色情
淫meimei贴图	色情
反人民	色情
全國人大	色情
手记注册日韩5006部激情电影	色情
淫癡	色情
肉箫	色情
六？四	色情
儿子淫奸姐姐穴	色情
外$$挂	色情
WG	色情
幼女口交	色情
淫乱图片	色情
久之游	色情
精液射入穴中	色情
毛鸟gm	色情
激情美女贴图九九情色	色情
邻居少妇 干邻居少妇 邻居的少妇 邻居美少妇 操淫荡少妇	色情
露毛	色情
ｆ ｕ ｃ ｋ	色情
抽插 捅 挺 阴唇 处女膜	色情
亞洲性虐	色情
fuck西藏独立	色情
天然むすめ 素人~このみ	色情
双鞋的故事	色情
yutong	色情
全球公审江泽民	色情
捐贈排行	色情
保密局	色情
乳	色情
PENIS	色情
兽交	色情
射精时必须注意的几件事	色情
*法*轮*功*靠	色情
小姐打飞机	色情
快……快……幹我……幹……我快忍不住了……哼…	色情
六四民运	色情
雞掰	色情
内射	色情
他干	色情
AYAWAWA	色情
bastard bastard	色情
扬振	色情
歇b	色情
毛江八	色情
薄码	色情
雞院	色情
香港成人电影网五月成人情色论坛	色情
玫瑰园	色情
淫秽	色情
realextreme	色情
淫奸医生	色情
梦城互动	色情
fuck社。会。正。义。力。量	色情
和两勇男玩30P	色情
ｍａｉ骚	色情
淫妇	色情
网址大全	色情
騷雞	色情
fuck温加宝	色情
全 国 两 会	色情
女也	色情
怪兽总动员	色情
fag	色情
TENGREN	色情
jb靠	色情
日本激情淫色视屏	色情
淫淫电影	色情
pp241淫色导航	色情
大肉棒插入湿湿的肉缝	色情
putain	色情
无码做爱淫图	色情
萬王之王	色情
1989六四	色情
nigga nigga	色情
ｋｋ粉	色情
做爱在线观看	色情
抽插55岁处女妹妹淫叫不断	色情
作秀	色情
抽插44岁处女妹妹淫叫不断	色情
毛发伦	色情
大龟头顶住她的花心深处	色情
日你妈啦屄	色情
粗大的肉棒………我受不了	色情
國 家 安 全	色情
肉棒插蜜穴	色情
干你	色情
黃色電影	色情
毛色情服务	色情
色狼小说	色情
18dy淫间道	色情
强*十八岁美女护士看完保证你打飞机免费电影	色情
发正念	色情
台湾成人骚b	色情
哥哥的肉棒好大啊	色情
激情淫色漫画论坛	色情
性	色情
軍民衝突	色情
宁王府娱乐	色情
西藏独	色情
测拿	色情
性爱	色情
毛摇头丸	色情
激情bt亚洲区	色情
Pink Puncher Premium Angel 光咲玲奈	色情
23dy淫色贴图	色情
wetback	色情
毛马卖马屁	色情
毛窃听器	色情
小穴收缩颤抖著	色情
妹妹的穴好紧	色情
联通移动秘密通道情色电影午夜成人电影	色情
狗B	色情
插妳	色情
古方迷香	色情
异见人士	色情
操淫荡护士穴	色情
┌	色情
操你八辈祖宗	色情
男女激情图片	色情
美乳艷娘	色情
辅助程序	色情
肉棒淫水嫩穴	色情
葫蘆案	色情
毛建设部	色情
jiejie的屄	色情
韩国三级电影	色情
CAO	色情
你娘咧	色情
精液射进穴里视频	色情
tianji	色情
鸡巴在她的阴道里抽插	色情
淫穴兽交	色情
挖挂	色情
毛强硬发言	色情
大鸡巴干进meimei的小穴	色情
嫩穴把肉棒包得紧紧	色情
網龍	色情
毛游戏发奖员	色情
把你的小穴夹紧……用力……	色情
獨裁	色情
本站10017多部激情电影全部免费试看三天	色情
古柯	色情
性视频聊天图幼女日屄视频脱衣聊天室明星	色情
肉棒的抽插淫荡少妇穴	色情
毛迷药	色情
姐姐的小穴	色情
淫貨	色情
se淫乱姐姐小说	色情
亚洲成人午夜场	色情
毛妓院	色情
2逼 老逼	色情
蒙古達子	色情
meimei嫩穴	色情
15年纪念日	色情
激情淫穴小妹	色情
陈良宇	色情
毛淫	色情
值勤	色情
抽插 …好刺激……好粗…	色情
肉棒插入阴户内	色情
三级片A片下载观看	色情
操护士穴真爽	色情
驶你老师	色情
肏jiejie屄	色情
发@轮	色情
法谪	色情
月经不调	色情
淫水丝袜	色情
李大师	色情
淫色贴图网	色情
婷婷成人激情网站	色情
戴秉囯	色情
輪攻	色情
售軟體	色情
民意论坛	色情
學生妹	色情
妈的b	色情
插meimei图	色情
和jiejie肏屄	色情
四川	色情
台盟	色情
警奴	色情
发$$抡	色情
45xp。com 电影免费	色情
妹妹社区淫色	色情
韩日成人激情影院	色情
日韩淫乱meinv图	色情
tta2	色情
EVENT	色情
人大代表大會	色情
王润生	色情
龟头用力刺入淫穴	色情
毛神通加持法	色情
毛国民党万岁	色情
干的爽	色情
日本激情片论坛	色情
哲 民	色情
Qzone精彩由你而来	色情
扒开她的嫩穴	色情
我 操 穴	色情
教你怎样延迟射精32岁以下禁免费淫电影a片	色情
淫奸熟睡的妈妈	色情
wowjingye	色情
六四周年祭	色情
午夜成人激情聊天室	色情
meinv小穴贴图偷拍少女乳房	色情
毒品	色情
张大权	色情
鸡巴小穴	色情
cao	色情
天怒	色情
斯蒂芬霍金	色情
毛纠察员	色情
LIHONGZHI	色情
无码丝袜	色情
鸡巴抽插好……爽	色情
毛我操你	色情
大家论坛	色情
幸运抽奖	色情
死亡笔记	色情
运营长	色情
胡喬木	色情
日本激情动漫	色情
插你老母	色情
抽插42岁处女meimei淫叫不断	色情
亲日	色情
鞭王	色情
魔兽金库	色情
驶你娘	色情
和两勇男玩7P	色情
淫妻浪女	色情
手记注册日韩5015部激情电影	色情
毛强卫	色情
西遊伏魔錄	色情
插的小穴都流水了	色情
推推俠	色情
文革	色情
免费dse淫乱	色情
fuck射精	色情
毛伊拉克	色情
法鯩功	色情
烟膏	色情
哪有a片 百万meinv贴图夫妻激情免费视频	色情
精液	色情
阿扁	色情
免费淫乱电影	色情
捅比	色情
免费淫奸女Ａ片段试看 令人喷血的春宫108姿势	色情
激情淫色电影	色情
ｓｏｕｌ ｕｌｔｉｍａｔｉｏｎ ｎａｔｉｏｎ	色情
生孩子沒屁眼	色情
韓桂芝	色情
手记注册日韩5017部激情电影	色情
插白洁小穴	色情
60xp。com 电影免费	色情
淫女 幼B	色情
淫城乱伦屋	色情
仙侣奇缘	色情
達赖	色情
AV	色情
敬国神社	色情
阴道好紧插起来那真是爽极了	色情
淫电影//现场强奸19岁处女扒开小穴清晰做爱阴道裸体图	色情
发~沦	色情
美體豔姿	色情
毛金日成	色情
狂插淫荡女护士	色情
毛商务部	色情
你的鸡吧好大啊干的我好爽哦	色情
亚洲激情妹妹	色情
北美仙人球碱	色情
幼女嫩逼	色情
feltch	色情
干GM的娘	色情
毛天安门录像带	色情
毛阴道	色情
眯	色情
崔英杰	色情
麗春苑	色情
品色永远免费淫电影	色情
劉雲山	色情
ｍｏ ｘｉａｎｇ	色情
恋爱盒子OL	色情
自焚	色情
毛游戏管理员	色情
河殇	色情
天下贰	色情
夜夜色娱乐网	色情
毛死GM	色情
情色 激情 meinv 穴	色情
肉棒插入肥肥的淫道	色情
法^淪	色情
┅	色情
猛將	色情
外—挂	色情
日本有碼	色情
杜智富	色情
Jj插入嫩穴	色情
老鸨	色情
肉棒插 嫩穴 淫穴	色情
ｆｅｎｇ ｋｕａｎｇ ｓａｉ ｃｈｅ	色情
99bb	色情
jiejie的小屄	色情
百家性大型黄色站	色情
狼族淫色群交蜜穴	色情
小澤圓(小沢まどか)的退隱作	色情
插女教师的屁眼	色情
銀行帳号	色情
毛贼东	色情
成人色情午夜激情	色情
监听器	色情
吗的	色情
亮穴	色情
操	色情
黄色免费淫电影母子淫奸电影	色情
d7se淫色穴图片和meinv发春激情3级片试看	色情
無碼精選	色情
穷逼	色情
婷婷淫色	色情
操鸡	色情
太子党	色情
亚洲性虐	色情
小乳头	色情
毛狂操	色情
眾志成城	色情
龟头挤进了姐姐的小穴	色情
六四以后	色情
毛我操	色情
跳大神	色情
台灣狗	色情
暗黑之門：倫敦	色情
毛卖国求荣	色情
膀胱	色情
小泉纯一郎	色情
王超华	色情
王丹	色情
弹 劾	色情
政治協商會議	色情
屁蛋	色情
强奸轮奸meinv视频	色情
黄色情挑艳情小说网骚妹妹成人论坛	色情
一四我	色情
省長	色情
我你老板	色情
淫电影//令人喷血的春宫108姿势(组图)18岁禁看	色情
spikegirls	色情
日本激情淫穴电影	色情
奸情	色情
鲍彤	色情
ㄐ掰	色情
fuck兴奋剂	色情
毛旅游局	色情
锦天	色情
少女被插	色情
王炳章	色情
做爱大全	色情
淫电影	色情
高潮白漿	色情
全裸	色情
淫贱妹妹贴图论坛	色情
屌西	色情
GM美國	色情
激情爽电影，夜夜最消魂！	色情
领土	色情
小姨的嫩阴道	色情
毛高校群体事件	色情
preteen sex preteen sex	色情
屄屄特写	色情
妈妈的	色情
51xp。com 电影免费	色情
乔石	色情
密洞	色情
17Game	色情
中国人都在上的四大当	色情
午夜激情电影	色情
获救	色情
美國佬	色情
色情网站	色情
g。m	色情
狂舔少妇两腿之间	色情
暴操淫荡小meimei	色情
妈个B	色情
丰满肥大有阴唇湿润了	色情
大肉棒深深地插	色情
通告	色情
法^仑	色情
免费看三级电影淫电影	色情
核工业基地	色情
f r e e d o m	色情
拉皮条	色情
發$輪	色情
meimei被操的淫水直流	色情
民航	色情
淫女在线看电影	色情
肉棒插干她的小穴	色情
狂插嫩穴 浪穴 骚穴	色情
干死你	色情
丽春苑	色情
被奸淫的女教師	色情
抽插54岁处女meimei淫叫不断	色情
本土無碼	色情
受災	色情
曹建明	色情
含住我的小鸡鸡	色情
乱伦+都市+制服	色情
天晴數碼	色情
發$$綸	色情
色色连	色情
撒泡尿	色情
扶不起的阿斗	色情
插的我好爽	色情
轮攻	色情
和熟睡的妹妹做爱教你一手	色情
濫貨	色情
silkroad	色情
毛六？四	色情
哥哥干的人家好舒服啊	色情
ｐｅｎｉｓ	色情
父女姐弟淫乱	色情
断电	色情
1989#事件	色情
淫奸美女图 淫奸刘亦菲	色情
fuck体育总局	色情
握住阴茎看准肉洞猛的一下插了进去	色情
毛骚逼	色情
赛你老母	色情
亚洲淫色网站	色情
几届中央政治局委员	色情
强奸23岁处女全过程/*妹阴毛小穴	色情
教你如何鉴别处男处女的方法(组图)18岁禁看	色情
好粗的大肉棒	色情
臺灣民国	色情
星際online	色情
久遊網	色情
免费注册看免费电影通道	色情
孫家正	色情
淫穴电影	色情
mes couilles	色情
星战情缘	色情
插穴淫图	色情
删号靠	色情
淫女疯狂偷情	色情
ｌｕａｎ	色情
教你怎样延迟射精25岁以下禁免费淫电影a片	色情
粗长的大肉棒	色情
白肌美女？琴也	色情
淫蕩貴婦	色情
毛老母	色情
骚逼	色情
你老母的	色情
江澤民	色情
吸吮肉棒	色情
电影免费试看	色情
毛美国之音	色情
测试員	色情
发~伦	色情
阴唇 黏液流下	色情
榮譽之戰I--鋼甲洪流	色情
运营者	色情
东热美女一个比一个强	色情
西洋美女	色情
台湾淫色电影	色情
美女嫩穴淫水直流	色情
他爹	色情
升达毕业证	色情
操你全家	色情
强奸十八岁美女护士看完保证你打飞机免费电影网站	色情
本站10017多部激情电影全部免费试看	色情
法淪	色情
中華人民共和國	色情
本站可能有不适合未成年人观看的内容	色情
毛伱妈	色情
鸡巴靠	色情
和jiejie插穴	色情
杨震	色情
阿姨的阴户好肥啊	色情
我和姐姐肏穴	色情
中国性爱城	色情
國 賊	色情
発妻	色情
狂插处女穴	色情
宁王府论坛	色情
發~掄	色情
吸精少女	色情
因特天盟	色情
幹全家	色情
操你老娘	色情
民航局	色情
妖美巨尻物语 - 风间ゆみ	色情
服务器	色情
調教虐待	色情
18成人网	色情
幹七八	色情
嫩穴【极品】阴蒂	色情
超淫荡丝袜meimei	色情
精子射到jiejie的穴里	色情
騷婦掰B	色情
老师和我做爱好爽	色情
个批	色情
民進黨	色情
蘇秀文	色情
迷奸药	色情
贱女人-淫护士	色情
fuck王太华	色情
李雪峰	色情
毛投毒杀人	色情
性之站	色情
发^^伦	色情
解放軍鎮壓	色情
如果你未满24周岁请自觉离开。	色情
张震	色情
fa轮	色情
老师小穴	色情
客戶服務	色情
激情 少女 成人论坛 乱伦	色情
震級	色情
凸肉優	色情
齷齪	色情
精液射进她的小洞	色情
羅幹	色情
酥癢	色情
bingnews	色情
xizang	色情
接班	色情
成人激情午夜	色情
fuck外挂	色情
毛穆斯林	色情
华通时事论坛	色情
龟头用里插入阴道	色情
手机自慰网	色情
日本第一av女优武藤兰被10男糟蹋全记录1小时	色情
6-4tianwang	色情
最淫官员	色情
張榕明	色情
毛嫩B	色情
法~掄	色情
……媽的騷穴癢死了	色情
如果你未满28周岁请自觉离开。	色情
毛外\挂	色情
回回	色情
肏屄好舒服	色情
免费淫色电影下载	色情
大阳具从后面插入她的小穴	色情
東北獨立	色情
肮脏美学	色情
发^纶	色情
额尔德尼	色情
絲襪足交	色情
毛奸夫淫妇	色情
鹿城最新娱乐bt 色情365	色情
好弟弟使劲干jiejie	色情
国产幼女屄屄套图	色情
妳老母的	色情
少妇嫩穴扒开嫩穴扒开嫩穴	色情
金毛学生妹	色情
TTMD	色情
彭冲	色情
性虐	色情
我有网	色情
肉慾	色情
干勒	色情
淫色成人网	色情
鸡吧阴茎插嫩穴小穴	色情
在线激情淫电影	色情
goqo	色情
整根阴茎没入她空虚已久的阴户	色情
坐台	色情
fuck温家宝	色情
龟头挤进了她的阴道	色情
弟弟淫奸熟睡jiejie	色情
鸡巴顶在女儿的嫩穴	色情
公车淫奸姐姐	色情
17爱网	色情
男女激情电影	色情
坤邁	色情
倭国	色情
毛丫头养的	色情
无界	色情
wowsupplier	色情
罢工	色情
毛管理员	色情
疆獨	色情
洗肠射尿	色情
天安门屠城	色情
發$侖	色情
澳洲光明網	色情
中国	色情
粗大的肉棒	色情
huang yi qun xia zhuan	色情
成人网站	色情
n0255 三国冬子 - 不用厌牝中出し廃弃処分 _k7	色情
买财富	色情
超級樂者	色情
吕秀莲	色情
毛迷奸药	色情
冯素英	色情
台独分子	色情
淫电影//处女第一次阴道做爱全过程(全套图片)	色情
迷幻药	色情
TABLE	色情
午夜激情免费电影免费看激情小电影	色情
午夜激情电影网	色情
肉棒插进蜜穴	色情
我和小姨子	色情
亲爱的快操我的B	色情
系统消息	色情
阴水	色情
日本淫荡meimei	色情
毛撒尿	色情
李老师	色情
淫奸护士论坛	色情
美女主持26小时全天激情热舞	色情
毛港澳办	色情
大*FA 弟*子	色情
搞比	色情
secretchina	色情
姦情	色情
日本天皇	色情
林祖涵	色情
嫩 流 插 肉	色情
儿子淫奸姐姐	色情
新金瓶梅	色情
皮條	色情
尉健行	色情
免费在线观看	色情
莫伟强	色情
ADMIN	色情
和两勇男玩21P	色情
灼热的龟头紧顶住柔嫩的菊花口	色情
┉	色情
香港两性激情文学区	色情
插他	色情
成人论坛	色情
希拉克	色情
61xp。com 电影免费	色情
女儿的阴道好紧啊	色情
tian zhi lian yu	色情
tiang tang	色情
谢非	色情
臺灣共產黨	色情
视频	色情
淫乱　爽电影	色情
龌龊	色情
毛瘸腿帮	色情
ＧＡＭＥ　ＭＡＳＴＥＲ	色情
激情	色情
Fuck	色情
大 史	色情
强奸23岁处女全过程/淫妹阴毛小穴	色情
吹喇叭	色情
肥嫩的阴部	色情
抡功	色情
情色照片	色情
午夜免费成人黄色	色情
meimei的小穴……舒服死了……	色情
知的障害	色情
幹GM	色情
露阴照	色情
龟頭	色情
ｇｕａｎｇ ｚｈｉ ｇｕｏ ｄｕ	色情
成人色情图片	色情
天阉	色情
极欲燃烧	色情
枪决女犯	色情
色情论坛	色情
抽叉jiejie	色情
成人電影	色情
克林頓	色情
廖锡龙	色情
操藏独	色情
王兆国	色情
择民	色情
香港顶极淫片	色情
华建敏	色情
走向圆满	色情
嫂狂欢隔壁小弟打手枪	色情
肥嫩嫩的大陰唇粉紅色的小陰唇	色情
毛恩格斯	色情
色天堂18禁	色情
龟头顶住她的花心深处	色情
bignews	色情
亂交	色情
淫荡娇妻打开双腿	色情
啊……快插啊……小屄美死了	色情
後庭	色情
鲍鱼贴图妖色成年网电影	色情
李建国	色情
張万年	色情
kao	色情
狂插少妇穴	色情
┑	色情
人也	色情
ｔｉａｎ ｘｉａ ｗｕ ｓｈｕａｎｇ	色情
胴体	色情
曰Gm	色情
學潮	色情
白梦	色情
毛南蛮子	色情
毒贩	色情
教你怎样延迟射精38岁以下禁免费淫电影a片	色情
看牌器	色情
阿呀娃娃	色情
大肉棒…插我……」	色情
大卵子	色情
毛他祖宗	色情
毛胡乔木	色情
麻痹	色情
meinv嫩穴 妹穴 亮穴 女人穴	色情
被操	色情
色情电影 色情排行榜	色情
插逼	色情
莖候佳陰	色情
买春堂	色情
乱伦都市	色情
mo li bao bei	色情
山本	色情
强奸39岁处女全过程/淫妹阴毛小穴	色情
蔣彥永	色情
qqtang	色情
粉红嫩穴 鲍鱼嫩穴=2	色情
毛卖党求荣	色情
靠爸	色情
姨妈的肥阴唇	色情
毛新党	色情
跨下呻吟	色情
又顶到我的子宫	色情
嫩bb	色情
妳娘的	色情
猛男狂干美女	色情
大鸡巴在她的蜜穴里抽插	色情
邱会作	色情
饿B	色情
干八个美女的小穴	色情
中条英机	色情
杂种	色情
情色文学	色情
看棋軟體	色情
网星艾尼克斯	色情
成人免费	色情
假币	色情
mingpaonews	色情
BASTARD	色情
华盛顿	色情
ａｒｃａｎｅ	色情
弓雖女幹	色情
外专局	色情
天主教	色情
抑制剂	色情
猛烈的挺送、肉体激烈的撞击	色情
干……干我……用力地干我……	色情
kan66免费电影	色情
realexterme	色情
互舔淫穴	色情
周锋锁	色情
红月	色情
懶8	色情
贱人	色情
李 录	色情
值勤帳號	色情
刘军	色情
ａ片	色情
毛湿透的内裤	色情
插入jiejie蜜穴	色情
儿子的肉棒顶到妈妈的花心	色情
netdream	色情
戴相龙	色情
阿扁万岁	色情
插她	色情
操大*FA弟*子	色情
天联世纪	色情
厕所盗摄护士姐姐性感	色情
应招	色情
色网址联盟	色情
插进 小穴 嫩穴	色情
av成人网	色情
騷棒	色情
娇妻超市被奸，淫荡妈妈之办公室助理	色情
操淫荡少妇 操淫荡护士 激情穴贴图	色情
成人色情乱伦影院	色情
遲浩田	色情
TMD靠	色情
淫水涟涟	色情
放蕩少婦賓館	色情
他妈	色情
硕大的龟头	色情
恥辱醫護免费	色情
rmb	色情
youxika	色情
熟女顏射	色情
綠色數码	色情
救灾	色情
猪聋畸	色情
计牌软件	色情
用我的舌头刮着她的阴蒂	色情
凌辱？妥？学？@～？？Δ畏耪n後～	色情
meinv与猪性交电影	色情
fvc	色情
游戏发奖员	色情
激战	色情
干炮插穴	色情
fuck驶你老母	色情
坐台的	色情
毛回民暴动	色情
和两勇男玩19P	色情
運营組	色情
教你怎样延迟射精42岁以下禁免费淫电影a片	色情
粗大肉棒从后面插入	色情
抽插42岁处女妹妹淫叫不断	色情
淫奸姐姐	色情
浪女	色情
免费顶级欲图禁片	色情
露B	色情
吗个	色情
骚逼大型成人色站	色情
操插妳	色情
时代论坛	色情
法十輪十功	色情
蔡庆林	色情
八九年那个春夏之交	色情
插 13p	色情
ma chang da heng	色情
錢 國 梁	色情
屍	色情
你的小穴好紧	色情
三级小电影	色情
滚那吗错比	色情
毛阴蒂	色情
廖承志	色情
毛妈比	色情
駛你公	色情
ｍｏ ｌｉ ｂａｏ ｂｅｉ	色情
浪穴	色情
潮吹喷射地狱 不行触摸的喘气 4P肉奴隶中出	色情
插的妹妹流淫水	色情
最大的性虐待及另類性生活網站	色情
fuck太子党	色情
免费在线淫电影下载	色情
色情靠	色情
郭罗基	色情
罢吃	色情
www。gpchina。com。cn	色情
母子姦情	色情
愈快乐愈堕落	色情
操淫荡妹妹穴	色情
鸠	色情
曾培炎	色情
新党	色情
大中华论坛	色情
淫奸嫂子穴	色情
出售此号	色情
NND	色情
解放军镇压	色情
凸肉优	色情
幻灵游侠	色情
六四参加者	色情
针孔偷拍	色情
风骚欲女	色情
jb	色情
eight仙靠	色情
换妻	色情
雞女	色情
WG武功	色情
干你媽逼	色情
ｘｉｎｇ ｋｏｎｇ ｈｕａｎ ｘｉａｎｇ	色情
扉之陰	色情
你奶奶	色情
making	色情
地藏	色情
ray-city	色情
干死	色情
强*十八岁美女护士看完保证你打飞机免费淫电影a片	色情
淫穴淫水流	色情
*法*轮*功*	色情
黃金聖水	色情
韓 聯 潮	色情
huan le qian shui ting	色情
什么什么大冒险	色情
大鸡巴顶进meimei的小穴	色情
低價金幣	色情
色情帝国黄站	色情
肉棒插入浪穴	色情
欲望	色情
┟	色情
默哀	色情
产权局	色情
法^^仑	色情
挺动我的下体	色情
龟头 插进 阴户	色情
肛门拳交	色情
美臀嫰穴	色情
幼女	色情
群交	色情
┊	色情
嗯…… 啊… 不要停…… 啊…… 插的再深一点…	色情
她的小穴插了进去	色情
操操gm	色情
小姨的穴	色情
正見網	色情
淫奸jiejie	色情
侦探设备	色情
迷奸系列	色情
李红痔	色情
成人黄色三级网站	色情
陈功	色情
性爱日记	色情
西藏国	色情
法^^轮	色情
操meimei湿穴	色情
劉少奇	色情
┅大力插┅大鸡巴	色情
搏客	色情
红顶商人	色情
龜投	色情
李师父	色情
妓女	色情
顏騎	色情
毛太子党	色情
cctv	色情
英雄online	色情
人學生妹妹 埼玉援交 vol。2 なな＆まい	色情
李 淑 娴	色情
宋祖英	色情
拍卖官	色情
和两勇男玩53P	色情
f r e e n e t	色情
真 善 忍	色情
學生愛國者運動證明	色情
fagtard fagtard	色情
戳比	色情
Fag	色情
老卵	色情
精子	色情
滾那嗎老比	色情
阴户紧紧包含着肉棒	色情
無套自拍	色情
人 民 內 情 真 相	色情
ｆｕｃｋ ｙｏｕ	色情
法*仑	色情
穴淫	色情
Kamikaze Girls Vol。29 铃房ありさ	色情
你爷	色情
外~掛	色情
马国瑞	色情
完美时空	色情
ｍａｏ ｘｉａｎ ｄａｏ	色情
尼克松	色情
杨元元	色情
群奸	色情
洗腸射尿	色情
朱鎔基	色情
cheng ji si han	色情
日本AV女優	色情
垮台	色情
gp	色情
哥哥使劲插我 爽死了 啊 啊	色情
漏B	色情
网捷信	色情
(无关键词)导航搜索	色情
母子乱淫贴图	色情
大人の隠れ汤 乱交游戯温泉へようこそ	色情
tEST	色情
王胜俊	色情
前凸後翹	色情
毛机巴	色情
針孔偷拍	色情
龜兒子	色情
fuck宋楚瑜	色情
甲基苯丙胺	色情
邮政局	色情
狂插meinv穴	色情
摸你雞巴	色情
饿b	色情
自由门	色情
換妻雜交	色情
口含鸡巴	色情
客户服务	色情
多維網	色情
赛博先锋	色情
法^^輪	色情
ｇａｍｅｍａｓｔｅｒ	色情
美少妇	色情
情色六月天mm淫乱	色情
龟头 磨蹭 插入 小嫩穴	色情
反动	色情
现场做爱偷拍电影	色情
meinv激情性交射精电影	色情
FALUNDAFA	色情
刘伯承	色情
幹x娘	色情
免费免注册在线淫电影	色情
成都锦天	色情
看牌软件	色情
夜色淫女导航	色情
李金華	色情
干你老比	色情
美女小穴贴图偷拍少女乳房	色情
盛宣鸣	色情
盗窃犯	色情
毛耶稣	色情
16dy-圖庫	色情
222se图片	色情
阴道里嫩肉把鸡巴包得紧紧	色情
大陆鹿城	色情
教你怎样延迟射精30岁以下禁免费淫电影a片	色情
╁	色情
超美混血兒(小泽玛利亚出道时的珍藏)	色情
男女交歡	色情
胡紧涛	色情
中国真实内容	色情
18dy免费	色情
幹你媽逼	色情
文殊	色情
拿着鸡巴对准小穴	色情
深夜進入少女家中玩強奸	色情
我和妹妹肏穴	色情
阿沛	色情
香港成人激情影院	色情
ｃｈａ你	色情
毛外/挂	色情
妹妹的阴户	色情
勃不起斯懦夫	色情
fuck希拉克	色情
龟头顶住她的阴户	色情
肏穴	色情
星際家園	色情
顶到阿姨的花心	色情
fuck我日	色情
尉 健 行	色情
亞情	色情
阴道夹的我好紧	色情
百家性淫网站	色情
ｋａｉ ｔｉａｎ	色情
天游	色情
MAD MAD	色情
毛蒙尘药	色情
刘云山	色情
尋仙	色情
吴 邦 国	色情
阴茎在我的肉洞中抽送着	色情
毛鸟GM	色情
开着摩托干了岳母	色情
淫meimei电影	色情
发*仑	色情
梁擎墩	色情
tian shi	色情
65xp。com 电影免费	色情
啊… 你弄的我好通啊 不要……不要……	色情
f a 轮	色情
中国论坛	色情
毛水利部	色情
巨乳美女RINA无码第2弹	色情
買財富	色情
淫奸女护士电影	色情
同性恋	色情
水浒Q传	色情
午夜的诱惑网友自拍	色情
淫虫	色情
淫色贴图	色情
少妇房中自淫，和两勇男玩8P，操得直叫爽 操日本淫女穴	色情
鸡巴 插 嫩穴	色情
轮子功	色情
蔣介石	色情
本站10005多部激情电影全部免费试看	色情
╊	色情
meimei的阴唇好大啊	色情
成人情色贴图	色情
淫女吃鸡巴	色情
阴道深处	色情
57xp。com 电影免费	色情
押大	色情
法@抡	色情
毛全国人大	色情
芸能人使い捨てM奴隷DX 聖乃マリア nike 新片！	色情
夏赞忠	色情
G_m	色情
色网阴道特写强奸24岁处女全过程	色情
成人动漫 成人文学网 成人小电影	色情
淫秽男女激情淫乱	色情
乱武天下	色情
赛他娘	色情
项英	色情
ayawawa	色情
毛李铁映	色情
淫荡少妇穴 操淫荡少妇	色情
人代	色情
操吹喇叭	色情
绝对女神	色情
黄色文学	色情
儿子淫奸妈妈穴	色情
精子 淫穴 淫液	色情
龙 虎 门	色情
捅她	色情
毛妳老母的	色情
奸幼	色情
干嫂子	色情
台湾18成人	色情
妳娘	色情
fuck圣女峰	色情
新郑和	色情
法腀功	色情
多人轮	色情
靠你媽	色情
成人淫图	色情
犯賤	色情
賤比	色情
jiejie的穴好大啊	色情
小电影免费看高潮屋贴图做爱视频表演	色情
小骚穴┅┅好舒服	色情
王俊博	色情
脫衣舞	色情
毛六。四	色情
ｖｒｔａｎｋ	色情
wangyou99	色情
毛卖卡	色情
老师被干小穴	色情
水浒	色情
h动漫	色情
50zhou	色情
护士淫乱	色情
乳沟	色情
日本激情淫穴网站	色情
吴弘达	色情
68wow	色情
东北独立	色情
希望之声	色情
27军军长	色情
血腥內幕	色情
粗大的鸡巴插入穴洞	色情
乳霸	色情
鄧朴方	色情
李作鹏	色情
刚发育好的处女就这么被干	色情
百家性大型娱乐黄站	色情
纪念松岛MM引退大作-松岛枫合集4	色情
就去诱惑	色情
日本激情淫穴贴图	色情
抽插50岁处女妹妹淫叫不断	色情
毛回教	色情
鋼甲洪流	色情
艳星诱惑	色情
林心如掰穴自拍	色情
一黨	色情
快干我!快干我┅┅我要被干	色情
美騷婦	色情
舔的下体湿润阴毛	色情
美国之音	色情
性高潮	色情
尉键行	色情
一次可看四位美女同床較勁很可愛的女主角	色情
刘国凯	色情
鹿城免费黄站	色情
屌7	色情
刘　淇	色情
靠北	色情
侬着冈峦	色情
處女	色情
狗狼养的	色情
滕人	色情
妹妹的小穴好紧啊	色情
淫奸姐姐 妹妹 MM 姨妈 舅妈直到流水	色情
插 3p	色情
淫荡少妇	色情
董文华	色情
纪登奎	色情
口爆吞精	色情
粉穴嫩逼	色情
ｃａｏ ｎｉ ｍａ	色情
脱内裤	色情
失密	色情
操穴贴图	色情
我上小姨子小说	色情
淫奸小姨子论坛	色情
本站10015多部激情电影全部免费试看三天	色情
大b	色情
東洋屄	色情
騷姐姐	色情
高级应招女	色情
王稼祥	色情
废物	色情
莎士比亚	色情
口含住鸡巴 精液	色情
免费淫色电影-无需注册	色情
民意	色情
耻辱轮奸	色情
伍凡	色情
淫妹阴毛小穴	色情
性交无码	色情
操屄	色情
手记注册日韩5022部激情电影	色情
龟头插入肉洞里	色情
国研	色情
抽插44岁处女meimei淫叫不断	色情
淫奸表姐论坛	色情
分家在	色情
湿淋淋的阴道	色情
毛食屎	色情
成人午夜場	色情
毛天皇	色情
江贼民	色情
吴仪	色情
乳交	色情
免费淫女看电影网站	色情
少妇房中自淫，和两勇男玩7P，操得直叫爽 操日本淫女穴	色情
嫩穴 搔穴	色情
世界日报	色情
皓宇互動	色情
發論功	色情
乱伦小说	色情
Admin	色情
磨得人家小穴……好用力……好酥	色情
亀頭	色情
巨灵神	色情
免费淫奸女Ａ片段试看 教你如何鉴别处男处女的方法(组图)18岁禁看	色情
法~~抡	色情
大法弟子	色情
升天	色情
操布什	色情
消灭共产党	色情
毛黎阳评	色情
波佳达	色情
法**侖	色情
金伯帆	色情
Tokyo Hot n0249 : 南丽美 菊攻无限中出39连発	色情
fuck fuck	色情
fuck天皇	色情
淫妇自慰	色情
媽個老比	色情
我占有了妈妈和阿姨	色情
毛乳波臀浪	色情
操那嗎逼	色情
UPDATE	色情
毛明慧网	色情
高嘉	色情
毛何候华	色情
强奸21岁处女全过程/*妹阴毛小穴	色情
fuck十八摸	色情
毛西藏天葬	色情
下载免费淫电影	色情
扉之阴	色情
fuck斯大林	色情
省长儿媳妇	色情
牛B，牛比	色情
艳情小说	色情
盜竊犯	色情
阴茎挺进狭窄的阴户	色情
8。9	色情
全免费淫色情电影	色情
国防科工委	色情
色空寺	色情
一边一国独裁	色情
分裂中國	色情
孤兒	色情
他奶娘的	色情
贾育台	色情
騷	色情
fuck乡巴佬	色情
免费成人激情视频聊天室	色情
赤匪	色情
ｌａｇｈａｉｍ	色情
minpaonews	色情
马场大亨	色情
射　精	色情
我将肉棒狠狠插入漂亮的老师小淫嘴抽插数十次	色情
tnnd	色情
免费淫奸女Ａ片段试看 20岁女大学生被强#(组图)全过程	色情
假阳具插穴	色情
ｆａｌｕｎ	色情
出售神符	色情
法棆功	色情
免费情色电影情色五月天	色情
李少民	色情
t2dk	色情
陰莖	色情
肉棒深深插入纖弱的肉洞裡	色情
cai hong qi shi	色情
少妇房中自淫，和两勇男玩6P，操得直叫爽 操日本淫女穴	色情
gong fu xiao zi	色情
堂品色 永远的免费色堂永远免费	色情
无码淫漫	色情
趙 海 青	色情
激情淫穴小	色情
烂游戏	色情
反人类	色情
针孔摄像机	色情
淫奸姐姐电影	色情
遊戲監督員	色情
性爱电影	色情
遊戲管理員	色情
小穴的淫骚香味┅好爽	色情
工力	色情
淫師蕩母	色情
法（轮）功	色情
朱蒙	色情
美女嫩穴	色情
天安門大屠殺	色情
淫奸jiejie meimei MM 姨妈 舅妈直到流水	色情
李禄	色情
法蜦功	色情
台湾自由联盟	色情
fuck新义安	色情
俄罗斯美少女惨遭蹂躏-嫩的不能再嫩	色情
金币网	色情
日本成人淫色DVD	色情
令人喷血的春宫108姿势(组图)21岁禁看	色情
狂插妹妹穴 淫水流	色情
干逼	色情
国外美女黄网 美女激情SM处女淫水图台	色情
扶正肉棒，瞄準她的肉穴插了進去	色情
六四参加者回忆录	色情
欧美清晰打炮淫乱人妖淫乱图	色情
娘	色情
奇淫宝鉴	色情
帐号	色情
毛新闻出版	色情
政治	色情
天使之戀	色情
用肥嫩的小穴套弄着我的阳具	色情
我把艳姨给干了	色情
老师干的我好爽	色情
拔屄自拍	色情
宋美齡	色情
尚禾	色情
felch	色情
征服小姐	色情
火热的精液喷射在子宫上	色情
发~抡	色情
新唐人电视台	色情
毛国务院	色情
中国大学 高清女厕盗拍 vol。01	色情
蒙巴顿	色情
揉阴核与嫩肉	色情
成人激情免费电影院	色情
wg886	色情
毛泽东靠	色情
操婊子	色情
夜色导航	色情
台湾是主权国家	色情
免费放淫电影**日本高校女生性交	色情
波霸	色情
挺入阴道	色情
苏振华	色情
鑫諾	色情
╈	色情
Gold Angel Vol。7 纹舞らん 可爱	色情
你他媽的	色情
激情成人聊天室	色情
美女裸体在线免费淫电影	色情
花园bt亚洲激情区	色情
i3hun	色情
处女流水淫图	色情
刀劍？英雄	色情
香港激情性爱影院	色情
杭州二元	色情
美女极品穴	色情
我和女大学生在公共汽车上做爱	色情
18岁少女处夜激情性爱电影下载中心	色情
齐墨	色情
亚洲成人激情	色情
臺	色情
免费成人电影图片	色情
懒教	色情
操jiejie的穴	色情
干 …插我的穴	色情
和护士姐姐淫穴	色情
小屄儿温暖滑嫩	色情
恼杀美巨乳美女~吉川萌	色情
毛环保总局	色情
淫水四益	色情
丁字裤翘臀	色情
淫奸表姐	色情
cdjp李鹏*	色情
人民广场	色情
吴学璨	色情
淫色护士小说 淫色故事 淫色文章	色情
刘俊国	色情
舔西	色情
jianghu	色情
色界	色情
卫生巾	色情
色网阴道特写强奸32岁处女全过程	色情
免费处女淫女下载看电影性开苞	色情
ｗｗｗ。ｇｐｃｈｉｎａ。ｃｏｍ。ｃｎ	色情
骚B熟女	色情
香港顶级淫片	色情
巨奶	色情
亚洲激情论坛	色情
萋	色情
激情论坛	色情
U R	色情
情色导航 激情爽电	色情
毛尉健行	色情
媽逼	色情
懶八	色情
jiejie的肥阴唇	色情
操小姨子	色情
二B	色情
手伸到下体抚mo嫩穴	色情
阿姨的大阴唇	色情
毛天皇陛下	色情
法~~掄	色情
成人午夜激情视频	色情
如此大的肉棒插的小穴快不行了	色情
神州天戈	色情
姐弟淫乱还玩3P	色情
meinv偷拍成人小说激情网香港激情图源成人色情论坛脱衣meinv做愛	色情
游戏道	色情
私—服	色情
陷阱超人嘩嘩曼	色情
美女主持24小时全天激情热舞	色情
毛卖财富	色情
毛摩门教	色情
最新娱乐黄站	色情
啊……我的小屄……给你……肏得好……舒服……啊	色情
爆炸	色情
幾八	色情
法*輪	色情
地 下 刊 物	色情
11。xp。com成人影院	色情
幼男	色情
免费淫奸女Ａ片段 免费在线观看	色情
39仓Ku	色情
他娘	色情
毛龟儿子	色情
弟弟的大肉棒	色情
大史纪	色情
小癟三	色情
骚货	色情
非常诱惑	色情
嫩穴	色情
more	色情
transvestit	色情
捅入meimei的阴道	色情
煙膏	色情
武林群侠传	色情
绿色数碼	色情
granado	色情
yuanming噴你	色情
新石器時代	色情
大话西游	色情
那妈	色情
ｓｅｘ	色情
fuck小泉纯一郎	色情
毛强奸犯	色情
ｓｈｅｎ ｚｈｉ ｌｉｎｇ ｙｕ	色情
ｌｉｎｇ ｙｏｕ ｊｉ	色情
發^^掄	色情
讨伐	色情
飘流幻境	色情
异议人士	色情
三反五反	色情
(盗摄)女子公共澡堂!	色情
金新月	色情
财政部	色情
本站10005多部激情电影全部免费试看三天	色情
幹死CS	色情
淫乱金发meinv	色情
兔妹妹贴图区	色情
发@沦	色情
男人若妻夢交	色情
kefu	色情
狗娘	色情
淫奸护士	色情
免费桃色电影不需注册	色情
午夜免费视频激情聊天室	色情
game17	色情
meinv淫图	色情
熟婦	色情
娘的	色情
乱伦熟女网	色情
365成人网站	色情
Pink Puncher~美熟女淫乱乳娘~Erotica : 友惠	色情
鲍威尔	色情
私*服	色情
美女性生活贴图	色情
两会新闻	色情
超級乐者	色情
福尔摩萨	色情
人民代表	色情
發$$論	色情
日本女优激情电影	色情
操mm穴	色情
性息	色情
官人我要2	色情
阴道口湿淋淋的	色情
网龙	色情
神曲	色情
点击观看*林心如做爱*色情电影	色情
董建華	色情
fuck驶你娘	色情
皇军	色情
淫奸meimei穴	色情
美女	色情
测试	色情
毛五星红旗	色情
第九城市	色情
中國遊戲中心	色情
纠察员	色情
蜜穴肉棒肉縫	色情
奶罩	色情
操 gm	色情
毛哈批	色情
成人	色情
法@@轮	色情
賤種	色情
飘飘	色情
fuck投毒杀人	色情
兆鸿	色情
操你祖宗	色情
逼樣	色情
李立三	色情
ｓｉ ｌｕ ｃｈｕａｎ ｓｈｕｏ	色情
u  r靠	色情
yxzbw	色情
日本mm性激情电影	色情
毛死全家	色情
莲花逼	色情
香港激情图源成人色情论坛脱衣美女做愛	色情
日gM	色情
dick呂秀蓮	色情
上海交警	色情
日军	色情
混 沌决	色情
法(轮)功	色情
g点	色情
淫色宝贝导航	色情
抗曰	色情
口交放尿	色情
人弹	色情
WEB战牌	色情
哥哥用力舒服死我了	色情
法菕功	色情
肛门	色情
噗嗤一声滑入阴道	色情
毛三民主义	色情
痛经	色情
岡巒	色情
cao你	色情
shen hua	色情
酥痒	色情
两性电影在线免费欣赏	色情
聚梦	色情
马大维	色情
盛大	色情
摇头丸	色情
群魔色舞	色情
毛片空姐的嫩穴裸体明星夜总会小姐贴图	色情
操大法	色情
和两勇男玩6P	色情
真善忍	色情
肉棒插入阿姨 ……爽呀	色情
女学生嫩B	色情
免费淫色情电影 教你如何鉴别处男处女的方法(组图)18岁禁看	色情
奶大穴肥多条肉棒难满足	色情
操陈功	色情
殘疾	色情
jing tian dong di	色情
Administrator	色情
免费午夜艳情电影	色情
新金瓶梅成人片	色情
骚包	色情
av貼圖	色情
何勇	色情
六四动乱	色情
fuck外/挂	色情
亚洲激情帖图	色情
砍翻一条街	色情
狂插少女的嫩bb	色情
陰締	色情
成人禁书	色情
护士穴	色情
独立	色情
四海龙女	色情
ｈｕｏ ｘｉａｎ ｒｅｎ ｗｕ	色情
婁義	色情
猪头	色情
Gold Angel Vol。8 仲村りお	色情
性愛擂臺	色情
众明星乱淫禁书	色情
毛高丽棒子	色情
天安门	色情
江西大余池江中学女教师(绝对真实)」	色情
学潮	色情
操丰满小穴	色情
日本妹妹	色情
金正日	色情
嗯┅┅嗯┅┅舒服死了……meimei又要丢了	色情
抽插41岁处女meimei淫叫不断	色情
圣堂科技	色情
中国之春	色情
本拉丹	色情
毛人大代表	色情
蒋中正	色情
shine	色情
红色恐怖	色情
淫娃	色情
毛独立	色情
美幼	色情
操女人穴 色情贴图 性交贴图	色情
张闻天	色情
艾滋病	色情
黄色免费淫乱电影强奸片	色情
淫亂熟女	色情
春色AV激情片	色情
李红智	色情
姦染	色情
插Gm	色情
想不到的黑幕	色情
激情淫色贴图论坛	色情
成人论坛导航	色情
毛多维社	色情
润星	色情
超級舞者	色情
性飢渴	色情
性感乳娘	色情
大粗鸡巴插进小穴	色情
肉棒插入妹妹小穴	色情
發^侖	色情
歌华	色情
裸聊	色情
chui chui	色情
潮吹喷射地狱 不行触mo的喘气 4P肉奴隶中出	色情
福莱斯特	色情
税务总局	色情
畜生	色情
你它妈的	色情
鸡歪	色情
筹码	色情
nnd	色情
用你粗大的肉棒	色情
又肥又紧的屄儿	色情
鹿城色meimei大型黄站	色情
裸	色情
娇妻超市被奸	色情
天安門事件	色情
【亚洲/无码】Mugen Vol。11 Ai Hazawa羽沢愛！【AVI/ 699MB】	色情
六四平反	色情
long hun	色情
董賤華	色情
美女偷拍成人小说激情网	色情
藏婦會	色情
抽插25岁处女妹妹淫叫不断	色情
毛教育部	色情
阿罗约	色情
处女第一次阴道做爱全过程(全套图片)	色情
性奴	色情
採花堂	色情
反日	色情
台湾裸体贴图成人免费电影	色情
hanbitsoft	色情
政府软弱	色情
疯狂抽送	色情
毛色情	色情
山咲Chiyuri	色情
叫春	色情
免费黄色淫秽电影	色情
色情网址网上视频	色情
民主	色情
台湾女人裸体贴图	色情
毛厕洞	色情
毛日X妈	色情
3D西游	色情
毛欲火焚身	色情
性福联盟 淫宝贝导航	色情
台灣国	色情
毛台湾民国	色情
拒绝食堂	色情
ｔｉａｎ ｄｉ ｘｕａｎ ｍｅｎ	色情
fuck傻B	色情
毛多维新闻	色情
封淫 Sky Angel Vol。50 宫泽Keito 超美系模特儿初无修正引退纪念作	色情
色mm的嫩穴	色情
巴赫	色情
免费痴女吸精	色情
無毛穴	色情
操 淫荡 好爽	色情
大紀元	色情
劉奇葆	色情
騷浪美女	色情
通知	色情
系統公告	色情
黃色影視	色情
午夜激情meimei	色情
午夜激爽电影网【成人电影色区】	色情
like999	色情
妈比	色情
操出售假币	色情
草的你妈	色情
做爱图片	色情
姐姐的小穴被大鸡巴插得好舒服哟	色情
吳邦囯	色情
风尘劫	色情
ｋｕａｉｋ	色情
毛三个呆婊	色情
ｆａｌｕｎｄａｆａ	色情
毛国管局	色情
Poon Poon	色情
3p炮图	色情
免费dse淫乱图片	色情
swdol	色情
以及家人	色情
强奸处女	色情
发$伦	色情
台湾 18 成人网	色情
系统	色情
淫色貼圖	色情
温总理	色情
拉手冲	色情
屍体	色情
毛黄色小电影	色情
┩	色情
臭机八	色情
精液射在妹妹的子宮	色情
硕大龟头紧紧顶著她的阴道	色情
草妈	色情
ｇｕ ｌｏｎｇ ｑｕｎ ｘｉａ ｚｈｕａｎ	色情
什麼什麼大冒險	色情
天閹	色情
天安門事件1989	色情
幹她	色情
尸體	色情
观看淫电影	色情
不要将你的精液射进我的小穴了里啊	色情
d7se淫色穴图片下载	色情
政府无能	色情
地 下 教 会	色情
滾滾球	色情
操操他	色情
ボインお姉さんお色気修行！ みさき優香	色情
免费淫奸女片	色情
成人午夜场	色情
干部	色情
操表姐	色情
教室炉轮奸精液过剰注入 若月秋穂	色情
中国游戏中心	色情
ｘｉａｎ ｌｖ ｑｉ ｙｕａｎ	色情
性交靠	色情
色色婷婷	色情
公车奸美女淫奸女电影试看。	色情
我是g和m	色情
免费淫奸女Ａ片段试看 母子淫奸乱轮现场看……	色情
王沪宁	色情
pp点点通	色情
BC	色情
惹火自拍	色情
帝国传奇	色情
大唐风云	色情
老师的肉棒好大啊	色情
林心如做爱我该死快乐情感乐园	色情
成人电影导航	色情
肉簫	色情
星戰前夜	色情
民政局	色情
蝴蝶谷淫图片	色情
永恒之塔	色情
舌头穴	色情
发伦功	色情
温州鹿城成人网	色情
幹死GM	色情
孕	色情
日本	色情
紅燈區	色情
玖玖金币	色情
色情 网 站 导航	色情
剑侠情缘	色情
淫奸小姨电影	色情
毛阴水	色情
激情淫影院	色情
zhengjian	色情
发~仑	色情
幹機掰	色情
無套內射	色情
免费裸体meinv性交电影	色情
vrtank	色情
鸡巴便结结实实的插进娇嫩的花蕊	色情
完全免费淫色电影	色情
干你妈逼	色情
捅进了她的阴道	色情
教育部	色情
狗卵子	色情
帶练	色情
粉穴	色情
鸡巴	色情
原子弹	色情
日本激情淫电影	色情
肉棒在阴唇上摩擦传来快感	色情
f l g	色情
下载免费淫色强奸电影	色情
u r	色情
fuck吴官正	色情
fuck升达毕业证	色情
欧美激情	色情
鹿城最新娱乐小说	色情
好死不如赖活着	色情
顺着红嫩的肉缝上下抚弄后插入小穴	色情
拦截器	色情
鹿城大型黄站	色情
tui tui xia	色情
？(SOD)超天然素材 桐島あゆみ	色情
任弼时	色情
梦遗	色情
mo你	色情
雪腿玉胯	色情
牛顿	色情
戳那吗B	色情
路易	色情
法輪功	色情
管里	色情
妹妹吸精	色情
自由亞洲	色情
淫奸	色情
調教	色情
大纪元新闻网	色情
soundofhope	色情
海底水中插屄~Aqua Sex	色情
┅┅别再磨了┅┅痒死啦！┅┅快	色情
long zu	色情
下陰	色情
日本淫色漫画 淫色少妇小说 淫色少妇	色情
操出售枪支	色情
册那娘比	色情
仙剑	色情
高麗朴	色情
强奸31岁处女全过程/淫妹阴毛小穴	色情
騰仁	色情
毛温总理	色情
高清性爱	色情
曾慶红	色情
美国佬	色情
幼女小嫩穴	色情
助理	色情
fuck倭国	色情
jiejie的肥穴	色情
┻	色情
日本激情淫穴	色情
野雞	色情
毛人弹	色情
达賴	色情
棒插到妈妈的穴里	色情
大肉棒	色情
毛黑社会	色情
毛军妓	色情
B毛	色情
ｔｒｉｃｋｓｔｅｒ	色情
屄毛	色情
apex	色情
sex大型色站	色情
小犬蠢一狼	色情
入穴一游	色情
免费台湾激情片	色情
不用注册免费小电影骚b免费色电影免费	色情
如果你未满20周岁请自觉离开。	色情
性伦乱小说	色情
发浪	色情
蒋介石	色情
吴宏达	色情
欧美淫奸女直接试看	色情
色妹妹成人论	色情
品嘗不倫主婦	色情
激情电影免费下载裸体meinv乳房图	色情
朱容鸡	色情
FLG媽B發掄	色情
插入蜜穴	色情
BLOW	色情
日本meinv鲍鱼贴图区	色情
粉嫩人妻在老公面前被人搞	色情
嫩肉 穴口 舌头	色情
mm美图	色情
劲爆	色情
狂乳激揺	色情
毛傅鹏	色情
嘻游中国	色情
勁舞團	色情
妈B	色情
爱抚淫女的阴户	色情
白肌meinv？琴也	色情
硬绑绑的阴茎插入阴道	色情
淫*女电影片段试看	色情
ｘｉａｏ ｙｕ ｅｒ ｙｕ ｈｕａ ｗｕ ｑｕｅ	色情
妹妹的小穴……舒服死了……	色情
測試员	色情
我扒开了她的阴道	色情
达芬奇	色情
台湾帝国	色情
saobi	色情
笨屄	色情
龙新民	色情
操戳你	色情
賀龍	色情
fuck吴邦国	色情
捅逼	色情
臭西化	色情
去妳妈	色情
日你爺爺	色情
极品成人3gp	色情
中国美女淫色贴图	色情
走向圆滿	色情
asiasex	色情
手指还插在她的淫穴	色情
他媽的	色情
一中一台	色情
超毛大鮑	色情
牛头马面	色情
艳照门	色情
自由亞洲電臺	色情
自由亚洲	色情
紅十字会	色情
KeFu	色情
AV成人影院	色情
推推侠	色情
爆乳	色情
肉棒插进了湿湿的阴道	色情
骸卒	色情
毛肉棒	色情
处女	色情
肉洞	色情
成人图片	色情
氣性壞疽病	色情
淫护士	色情
ｗｏｒｍｓ	色情
嗎b	色情
宋任穷	色情
秘书长	色情
三級片	色情
小B	色情
东方资通	色情
亚洲激情淫搔穴贴图	色情
ｍｏ ｓｈｏｕ ｓｈｉ ｊｉｅ	色情
姐姐的嫩穴 mm嫩穴	色情
人妻做爱	色情
社科院	色情
金发表姨子的鲜嫩蜜穴	色情
喷精	色情
毛私服	色情
监禁陵辱	色情
和两勇男玩38P	色情
插那吗B	色情
免费激情聊天室	色情
月宫套图社	色情
伤亡	色情
江氏	色情
免费淫奸女Ａ片段	色情
长身丝袜meinv~赤く烂れたマンコが痛	色情
wowcaifu	色情
刘华清	色情
法~淪	色情
霍金	色情
王希哲	色情
夢見る大和撫子 Pretty Little Asians Vol。48	色情
免费成人激情电影	色情
酣乐欣	色情
发沦	色情
法^^倫	色情
连続失禁	色情
13點	色情
meimei做爱	色情
噴精	色情
jiejie被插的好爽	色情
丁关根	色情
fuck统计局	色情
精液浴	色情
你爸	色情
小嫩穴把大鸡巴包得紧紧的	色情
小女嫩穴	色情
释迦牟尼	色情
GM	色情
密穴贴图	色情
18Chinese Japanese AV Girls	色情
共產主義	色情
毛六四	色情
狂插儿媳妇的阴道	色情
金瓶梅免费电影院	色情
1001an。com	色情
又硬又粗的肉棒	色情
rplan	色情
王八蛋	色情
毛驶你老师	色情
私-服	色情
和两勇男玩41P	色情
信長之野望	色情
小嫩穴贴图	色情
毛三去车仑	色情
meinv主持27小时全天激情热舞	色情
烂逼	色情
亚洲成人激情淫穴	色情
Red Hot Fetish Collection Vol。41若叶こころ	色情
日本熟母	色情
李克强	色情
封神傳說	色情
无码长片	色情
性感肉絲	色情
嫩穴　狂　插	色情
大波粉b	色情
fuck新党	色情
强奸26岁处女全过程/*妹阴毛小穴	色情
吳官正	色情
毛煞逼	色情
大妈油	色情
五不	色情
操参事室	色情
步飞烟	色情
扒开嫩阴道	色情
特派员	色情
毛花柳	色情
售卡	色情
亚洲互动	色情
fuck我干	色情
中国猪	色情
國產騷貨	色情
鴉片	色情
熟妇人妻	色情
插穴 美穴 ……好爽	色情
抽插52岁处女meimei淫叫不断	色情
摸你鸡巴	色情
成人午夜场，吸精痴女护士	色情
陈昌智	色情
李 月 月 鳥	色情
刷钱	色情
强奸犯	色情
法@@輪	色情
u r靠	色情
梅花网	色情
roiworld	色情
喷　射	色情
四川独立	色情
李月月鳥	色情
發^綸	色情
妹妹的穴好多水	色情
美女穴自拍	色情
干你妈b	色情
毛靖国神社	色情
反恐委员会	色情
血洗天安门	色情
校花沉沦记	色情
夫妻激情自拍图	色情
干meimei小穴	色情
ｅｎｃｕｌｅｒ	色情
神泪	色情
舔B	色情
春药	色情
操大便	色情
花心成人论坛	色情
鸡巴插肉缝 淫荡 小穴	色情
Kamikaze Girls Vol。30-中野美奈	色情
奸	色情
少女激情自拍	色情
冈峦	色情
江罗	色情
俄国	色情
小穴套着鸡巴	色情
阴精	色情
meimei小穴好紧	色情
臭西	色情
欧美淫色贴图网址	色情
舔吮她的阴唇	色情
成人午夜影院	色情
台湾独立	色情
不得入内	色情
手记注册日韩5010部激情电影	色情
毛林彪	色情
破天一剑	色情
野性家庭女教師	色情
操陈良宇	色情
輪奸	色情
狂插小嫩穴	色情
毛工作人员	色情
刘凯中	色情
韩国身份证	色情
天地玄门	色情
护法	色情
张磊	色情
西藏國	色情
大众成人网站	色情
meinv嫩穴	色情
Tora Tora Gold Vol。23 : ほしのゆき Yuki Hoshino	色情
法仑	色情
肉棒插入湿淋淋的肉洞	色情
经社理事会	色情
受傷	色情
日本灌肠	色情
咪咪爱大型黄站	色情
吹萧	色情
金鳞岂是池中物	色情
少妇房中自淫，和两勇男玩0P，操得直叫爽 操日本淫女穴	色情
和两勇男玩5P	色情
操那吗比	色情
洛奇	色情
淫电影//富豪们的疯狂做/爱方式	色情
月卡	色情
鸡巴射出精液　 泄了	色情
靖国	色情
昝愛宗	色情
伦功	色情
神風~ Kamikaze Street Vol。 13 : 里山加与	色情
严隽琪	色情
天聯世紀	色情
人肉搜索	色情
强*十八岁美女护士 看完保证你打飞机	色情
抽插38岁处女妹妹淫叫不断	色情
裸体妹妹林心如穴	色情
春藥	色情
鸡鸡	色情
别他妈的装	色情
发~~伦	色情
Tokyo Hot n0232 : 真宫梨沙子 傲慢RQ中出责备紊乱呼吸	色情
ｙｉ ｗａｎｇ ｃｈｕａｎ ｓｈｕｏ	色情
淫奸meimei的屄	色情
母子淫*乱轮现场看扶正肉棒	色情
阎明复	色情
温暖的冬夜老师拼命亲吻我	色情
傳奇3G	色情
1989天安门	色情
雞芭	色情
ｓｈｅｎｇ ｚｈａｎ	色情
日X 媽	色情
按摩棒	色情
操草你妈	色情
插入妈妈的穴好爽	色情
曰你	色情
国产嫖娼	色情
1989年6月4日	色情
激情成人影院	色情
徐和柴学友	色情
发愣	色情
又肥又嫩的小骚屄儿	色情
火线任务	色情
銀民吧	色情
法磮功	暴恐
pao pao	色情
日本有码	色情
亚洲成人情色网站	色情
傅志寰	色情
熟睡中的妹妹	色情
法@@綸	暴恐
艳舞淫业	色情
人民真实	色情
亂武天下	色情
倒臺	色情
毛叫床	色情
铁道部	色情
亚洲激情淫贴图	色情
欧美激情淫色	色情
情色藝術天空	色情
转化	色情
fuck小鸡鸡	色情
性爱擂台	色情
在线淫电影	色情
白虎小穴	色情
热血江湖	色情
捐款名单	色情
fofg媽的	色情
回民暴动	暴恐
学生暴动	暴恐
緊穴	色情
抽插36岁处女妹妹淫叫不断	色情
毛毛主席	色情
绝品美女が恍惚颜の绝顶快感	色情
高丽棒子	色情
九評	色情
周莹	色情
售ID	色情
淫电影//教你如何鉴别处男处女的方法	色情
卖B发论公	色情
色情 娱乐 导航	色情
操逼毛	色情
亚洲成人无码	色情
护士嫩穴扒开嫩穴嫩穴	色情
少妇小穴被操的很爽	色情
口头检查	色情
黄色免费电影meinv	色情
秘唇	色情
阿旺晋美	色情
阴核	色情
亚洲成人激情网站	色情
nmis	色情
成人免费电影	色情
瓜批	色情
taip	色情
插进小穴射了	色情
wan wang zhi wang	色情
淫窝窝	色情
政協	色情
幼女狗交	色情
猛干 添	色情
掰开嫩穴 淫液	色情
遊戲新斷線	色情
火药制作	色情
肉棒 用力 肉縫	色情
阴部翻过来看超拽	色情
我的肉棒仍然在滴著精液	色情
江猪	色情
免费台湾18 电影	色情
星鑽物語	色情
陷阱超人哗哗曼	色情
插入meimei穴中	色情
人体炸弹	色情
大陆娱乐免费黄站	色情
YOUXIKA	色情
二奶大赛	色情
推油	色情
李宏志	色情
通用娼婦	色情
sars	色情
政治打击	色情
淫荡女医生	色情
放荡熟女	色情
cdjp	色情
杨周	色情
手记注册日韩5000部激情电影	色情
法功	色情
干全家	色情
陈慕华	色情
怎样延迟射精22岁以下禁	色情
怎样延迟射精25岁以下禁	色情
本土无码	色情
愛田由~(Moodyz)女教師 レイプ 輪姦	色情
卖QQ	色情
法**論	色情
小嫩穴流血了 流水了	色情
GOQO	色情
夜總會	色情
交換夫妻	色情
小骚货	色情
ｔｅｎｇｗｕ	色情
自残	色情
karma	色情
阴门	色情
大雞巴	色情
fuck推油	色情
未满19岁的请自行离开 ！	色情
毛王岐山	色情
……浪穴……大肉棍	色情
重题工	色情
卫生部	色情
炮友之家	色情
gamemaster	色情
莫索里尼	色情
原千寻~白领迷奸 Finger Charm	色情
亚洲淫色图	色情
UR	色情
熟女家政妇 山本ちづこ	色情
群奸乱交	色情
wizardsoft	色情
少女露嫩穴 少妇嫩穴 美女的嫩穴	色情
色狼小說	色情
ｍｅｎｇ ｈｕａｎ ｇｕｏ ｄｕ	色情
少妇房中自淫，和两勇男玩13P，操得直叫爽 操日本淫女穴	色情
全家死光光	色情
喇嘛	色情
姐姐的阴唇好大啊	色情
点对点裸聊	色情
傅铁山	色情
湿湿的阴户不断地在大鸡巴上磨擦	色情
毛鸟Gm	色情
淫屄	色情
美麗世界	色情
刀OL	色情
pute	色情
司马璐	色情
内衣	色情
吾爾開西	色情
銀行账號	色情
vgbh	色情
WANZ)强制猥亵 非合法ドラッグ	色情
大鸡巴插进小穴	色情
蘋果日報	色情
情感视频欣赏	色情
傻卵	色情
暴乳	色情
灾	色情
如果你未满34周岁请自觉离开。	色情
毛台湾帝国	色情
发*论	色情
色站排行导航	色情
wowassist	色情
乳尻	色情
慰安婦	色情
無碼H漫	色情
床上夫妻激情自拍图	色情
乳射	色情
美脚残酷物语膣壁浸透汁	色情
一元激情电影	色情
testicle	色情
淫逼嫩穴清晰图	色情
畜	色情
激情套图	色情
dse淫乱小说在线看	色情
干	色情
sm援交	色情
89学潮	色情
新聞出版總署	色情
多位东热女优参演	色情
厲無畏	色情
八九民主运动	色情
嗯┅┅嗯┅┅舒服死了……妹妹又要丢了	色情
52xp。com 电影免费	色情
釋迦牟尼	色情
和两勇男玩47P	色情
ㄙㄞ你公	色情
关卓中	色情
舌头在小穴周围舔弄	色情
法^^掄	色情
法耣功	色情
操比	色情
又大又紧的阴户	色情
wu hun	色情
多維新聞	色情
毛蒋介石	色情
色网阴道特写强奸28岁处女全过程	色情
高级卖淫女确实不一般	色情
李嵐清	色情
澳洲光明网	色情
陽具	色情
亚洲艳情男女图吧	色情
冊老	色情
挺着硬梆梆的肉棒	色情
草你妈靠	色情
毛系统公告	色情
杜冷丁	色情
最强美乳おたま初解禁	色情
台湾身份证	色情
咬着龟头	色情
system	色情
周恩来	色情
無盡的任務	色情
江則民	色情
阿拉	色情
天天情色	色情
发骚	色情
跟meimei肏穴好舒服	色情
小逼	色情
毛胡耀邦	色情
毛黄色电影	色情
懒八	色情
靖国神社	色情
華義	色情
混亂冒險	色情
干它	色情
厕所偷拍	色情
腚眼	色情
操妹妹湿穴	色情
免费在线激情电影	色情
肏穴好舒服	色情
淫护士小说	色情
ri	色情
jiang shan	色情
哥哥的大肉棒	色情
发**抡	色情
nude nude	色情
一本道1137~陵辱巨乳~薫まい	色情
残廢	色情
捻	色情
8岁女生主动让男生开苞全过程	色情
月經不調	色情
雞巴暴脹	色情
性爱 图库	色情
紅十字會	色情
ghost	色情
tibetalk	色情
日片罕见3P加肛交	色情
湿淋淋的阴道被肉棒插出血	色情
馬巧珍	色情
Red Hot Fetish Collection Vol。28	色情
梦幻之星	色情
人民之声论坛	色情
发^^纶	色情
激情淫洞小说	色情
卖比	色情
色色成人	色情
ｑｑ幻想	色情
积克馆	色情
毛想上你	色情
淫妹妹成人娱乐	色情
Fuzz Vol11 Ririko Asahina 朝日奈りりこ 加藤つばさ	色情
婊	色情
祖宗	色情
恩格斯	色情
高麗樸	色情
外？？挂	色情
揚震	色情
蔡崇国	色情
妳媽的	色情
成人網站	色情
张开的小阴唇	色情
毛人体炸弹	色情
文化大革命	色情
肉棒插到妈子宫 ┅┅爽死了	色情
江豬	色情
台湾色色导航	色情
龟头在阴唇上抽插	色情
tantra	色情
混蛋神风流史	色情
林肯	色情
他妈的	色情
亚洲激情	色情
操逼	色情
好肥的阴户	色情
成人图片导航	色情
恥辱醫護bt下载	色情
narod。ru	色情
淫meimei	色情
新体操(仮)～妖精达の轮舞曲～	色情
毛上妳	色情
阴道里的大肉棒用力顶着	色情
轉法輪	色情
fuck台湾共和国	色情
mm的诱人双峰→免费试看片	色情
狂插淫洞 明星陰穴	色情
姑妈的阴道好紧啊	色情
ｈａｉ ｚｈｉ ｙｕｅ ｚｈａｎｇ	色情
下流地带	色情
实现你的幻想	色情
夏夏小说黄站	色情
光宇华夏	色情
fuck希特勒	色情
操博讯	色情
熟婦騷器	色情
粉屄	色情
賣國	色情
毛共产主义	色情
中国娱乐黄站	色情
民族	色情
千岛湖之旅	色情
宁王府	色情
毛高校暴乱	色情
G。M	色情
┅┅妈舒服死了	色情
fuck特码	色情
温 元 凯	色情
meinv穴	色情
逼你老母	色情
百家性大型免费黄站	色情
贩毒	色情
欢乐潜水艇	色情
AV足球賽11男VS11女大對決	色情
特码	色情
海盗的悠闲生活	色情
盛华仁	色情
吮吸肉棒	色情
雅典娜	色情
爽爽爽台湾成人贴图	色情
狗比	色情
和妹妹做爱	色情
靖國神社	色情
Crazy Fuck : Miki Uehara 上原美纪	色情
嗎啡	色情
台湾万岁	色情
女优爽图	色情
驶你母	色情
上山下乡	色情
免費性愛電影	色情
肉棒插入阴道里	色情
金瓶梅4	色情
肉棍狂插嫩穴	色情
夜夜色大型网站	色情
干机掰	色情
新西遊記	色情
我跟meimei肏穴	色情
ｌｉｎｅａｇｅⅡ	色情
亚洲**联盟激情视频 免费下载做爱图片	色情
武林外轉	色情
盐酸二氢埃托啡	色情
毛窃听器材	色情
长身丝袜美女~赤く烂れたマンコが痛	色情
甜嫩穴	色情
毛妈批	色情
掌上靈通	色情
骚屄娘们儿	色情
持不同政见	色情
国资委	色情
jian xia qing yuan	色情
大肉棒插入阴户内	色情
fuck驶你母	色情
核武器	色情
温逼	色情
166网址宽频影院网	色情
厕所盗摄美女性感	色情
台湾女人裸体贴图香港成人电影网	色情
弓雖	色情
强奸20岁处女全过程/*妹阴毛小穴	色情
中文情色网址导航	色情
那吗B	色情
津瑞	色情
三级淫水写真	色情
强奸28岁处女全过程/淫妹阴毛小穴	色情
国军	色情
哗哗曼	色情
毛夜情	色情
插逼清晰图	色情
李紅志	色情
我和meimei肏穴	色情
fuck色情电影	色情
你它馬的	色情
熟婦人妻	色情
妹妹的阴唇好嫩啊	色情
挨球	色情
毛高俊	色情
带炼	色情
操操	色情
好长的肉棒	色情
傅申奇	色情
毛傻B	色情
欲火	色情
强奸17岁处女全过程	色情
nage	色情
口活	色情
幼逼	色情
想上你	色情
工自联	色情
淫色贴图365	色情
舌尖不断在肉缝里上下舔着	色情
f a l u n	色情
她媽地	色情
發$$掄	色情
邪恶的党	色情
雙峰微顫	色情
何加棟	色情
在线淫影院	色情
西游	色情
蔣彥永上書	色情
AV OPEN)(TOD129)近亲3姐妹狂乱夜	色情
食精	色情
丁香成人社區	色情
┲	色情
将肉棒插进她身体的最深处	色情
無網界	色情
大東亞	色情
女友坊	色情
淫穴小说	色情
淫穴贴图	色情
毛骚货	色情
台湾成人网站	色情
美乳鬥豔	色情
跑跑卡丁车	色情
色女乳房阴道	色情
柯庆施	色情
东方传说	色情
┅我要泄了┅┅喔	色情
含鳥	色情
中华民國	色情
mxd	色情
傻鸟	色情
金庸群侠转	色情
删 号靠	色情
洗着鸳鸯浴操屄真惬意	色情
法綸	色情
毛干你妈逼	色情
就去日	色情
泡泡堂	色情
不良詞語@美乳女神RINA（中文字幕）	色情
亞洲瘋情	色情
安拉	色情
王樂泉	色情
代表大会	色情
biaozi	色情
小姨子穴	色情
色情电影 卡通 成人 av 少女	色情
毛meimei黄站	色情
操妳祖宗	色情
epochtimes	色情
猛插表姐	色情
恐怖主義	色情
叼你媽	色情
色网阴道特写强奸30岁处女全过程	色情
摸陰蒂	色情
又大又肥的屄	色情
紅 燈 區	色情
黄色做爱小说	色情
插你媽	色情
几巴	色情
sm舔穴	色情
popkart	色情
欢乐性今宵	色情
赌球	色情
极品白虎	色情
透视软件	色情
BnB	色情
fuck审计署	色情
用力狂插骚穴 ┅┅好爽	色情
美女激情性交射精电影	色情
徐向前	色情
江ze民	色情
淫色电影论坛	色情
妹妹的阴唇好大啊	色情
爱幼阁	色情
金瓶梅1	色情
大鸡巴操得我好爽啊	色情
降半旗	色情
抽插20岁处女妹妹淫叫不断	色情
淫奸美女	色情
人体摄影	色情
肉棒在阴道内抽插	色情
华夏文摘	色情
插淫妇骚穴	色情
痴美女醫生松島	色情
杀人	色情
性交課	色情
内裤	色情
共軍	色情
拉丹	色情
下流地帶	色情
色网阴道特写强奸31岁处女全过程	色情
王洪文	色情
毛生孩子没屁眼	色情
pp 点点激情片播放	色情
肉棒	色情
丁香成人论坛贴图区	色情
裙下風光	色情
urban	色情
法$$论	色情
梦中的女孩	色情
成人激情淫论坛	色情
五月四日	色情
遥想当年春衫薄	色情
師春生	色情
淫書	色情
丁香欧美成人贴图区	色情
cock cock	色情
根正苗红	色情
达赖	色情
浴室乱伦	色情
小穴被我操的红肿	色情
89运动	色情
ｒｉ ｎｉ ｍａ	色情
操淫荡护士 操淫荡 空姐操	色情
妓女自拍	色情
毛水去车仑	色情
他妈地	色情
真三國無雙OL	色情
卖号	色情
淫人情色导航	色情
jiejie的肥阴户	色情
舔着两片湿润的阴唇	色情
四人幫	色情
管里员	色情
王兆囯	色情
game master	色情
三去车仑工力	色情
妹妹的阴道真紧	色情
龙与地下城	色情
夫妻多p	色情
黑屄	色情
59xp。com 电影免费	色情
英雄世紀	色情
淫荡口交	色情
卖国	色情
辛灏年	色情
毛淫叫	色情
调理劳务系	色情
拔出来	色情
少妇野外淫穴	色情
强硬发言	色情
卢福坦	色情
神風痴女生中出！【MKV/767MB】	色情
fuck新闻出版总署	色情
北大三角地论坛	色情
鸡叭	色情
jinv	色情
干你良	色情
Sex Sex	色情
被插	色情
免费bb电影	色情
陳總統	色情
海盗时代	色情
淫兽学园	色情
蒙古独立	色情
韩联潮	色情
少妇被强奸密穴流水	色情
色情五月天	色情
兔meimei贴图区	色情
色咪咪	色情
创意鹰翔	色情
肏meimei的小骚屄	色情
陈良	色情
爹娘	色情
錯比	色情
李 月 月 鸟	色情
毕加索	色情
激情电影在线注册	色情
肉感炮友	色情
操陈希同	色情
搔妹妹黄站	色情
婷婷俱乐部	色情
针对台湾	色情
fuck他爹	色情
恋爱盒子	色情
她妈靠	色情
儿子的肉棒好大啊	色情
肉棒狂插好爽　插我	色情
日本女优8分钟长片	色情
creaders	色情
毛二逼	色情
勁暴	色情
野性家庭教師	色情
婊zi	色情
ａｄｍｉｎ	色情
ｍａ ｃｈａｎｇ ｄａ ｈｅｎｇ	色情
一次可看四位meinv同床較勁很可愛的女主角	色情
操臭化西	色情
免费淫色meimei电影网	色情
色情网站 色情导航	色情
靓穴meinv	色情
fuck我妳老爸	色情
巨乳meinvRINA无码第2弹	色情
国外A片电影	色情
嫩穴狂插直到痉挛	色情
阿不來提•阿不都熱西提	色情
夫妻3p	色情
亞洲有碼	色情
江戲子	色情
肉壁	色情
淫乱jiejie小说	色情
外@@挂	色情
性趣	色情
肛門	色情
诱惑女教师	色情
性交無碼	色情
meimei淫图	色情
肉棒又粗又大少女又痛又爽	色情
毛佛展千手法	色情
fuck社保基金会	色情
操腫	色情
lineage2	色情
luan wu tian xia	色情
爷爷	色情
毛泽東	色情
王岐山	色情
毛干妳老母	色情
cs	色情
淫奴	色情
阴茎插入肉洞里	色情
極品黑絲	色情
女人被迷奸的时候也很爽	色情
挥发型迷药	色情
草你妈	色情
3P炮圖	色情
在线激情电影	色情
巧淫奸戏	色情
强奸37岁处女全过程/淫妹阴毛小穴	色情
法$纶	色情
操操你妈	色情
本站10002多部激情电影全部免费试看	色情
手记注册日韩5023部激情电影	色情
台灣民国	色情
好大的阴唇	色情
Shit	色情
Waigua	色情
日本成人乱伦	色情
毛联大	色情
fuck台湾党	色情
planetside	色情
夫妻俱樂部	色情
Tora-Tora-Tora Vol。22 : 冬月ひな	色情
母子乱乱论	色情
韩 联 潮	色情
淫奸护士电影试看	色情
Sb	色情
拉客	色情
無產階級	色情
毛日你娘	色情
毛外-挂	色情
李小鹏	色情
翹臀嫩穴	色情
瘟b	色情
日你妈	色情
毛反共	色情
apexon	色情
凯图科技	色情
精液喷入穴	色情
海盗王ONLINE	色情
张 伟 国	色情
中国成人论坛	色情
操打炮	色情
ｔｏｎｇ ｓｈｉ ｔｉａｎ ｄｉ	色情
六四	色情
毛妈逼	色情
顶级轮奸套图站	色情
街頭籃球	色情
鸡巴插入拔出 真舒服	色情
毛姣西	色情
游戏监督员	色情
黃色小說	色情
激情色情	色情
于永波	色情
100ONE VIP MEMBERS	色情
香港色情影星美女裸体	色情
刘宾雁	色情
青楼	色情
强奸18岁处女全过程/淫妹阴毛小穴	色情
李 旺 阳	色情
删 号	色情
8 仙靠	色情
罂粟	色情
陰部	色情
少妇操尿穴	色情
14se淫色图片 免费vagaa电影 免费电影	色情
免费a片日本淫电影	色情
八仙靠	色情
他媽地	色情
窝窝色网之家	色情
毛民进党	色情
可可精	色情
毛人民大会堂	色情
毛天鹅之旅	色情
乱伦淫书丝袜淫图	色情
網路創世紀	色情
午夜场	色情
六四平暴	色情
肉棒插入淫荡少妇穴	色情
365免费情色网欢欢成人娱乐	色情
你它马的	色情
一夜欢	色情
错逼	色情
fuck威而柔	色情
中医药局	色情
falu	色情
龟头在嫂嫂的小穴穴口研磨	色情
毛圣女峰	色情
我漂亮的老师狗爬式做爱现场	色情
司法部	色情
中国最淫的免费淫图图	色情
我妳老爸	色情
掌上书城	色情
淫亂	色情
色情網站	色情
台湾身材一流meinv楼梯性爱	色情
fuck想上你	色情
露逼	色情
毛回良玉	色情
tianxungame	色情
肉棒 小穴里抽送	色情
足球经理在线	色情
客户服务人人员	色情
小穴流水妹妹手指插	色情
极品波神	色情
龟头插花心深处	色情
社。會。正。義。力。量	色情
阴精喷向龟头	色情
fuck系统公告	色情
現役看護婦	色情
long yu di xia cheng	色情
张健	色情
花柳	色情
妹的穴	色情
Ｇｍ	色情
meinv主持24小时全天激情热舞	色情
侧那	色情
日翻	色情
56xp。com 电影免费	色情
見到這個meinv就會有性欲	色情
vaameline	色情
fuck宋祖英	色情
混沌诀	色情
桃色　激情电影	色情
姦淫電車	色情
毛董建华	色情
鰻の罪と泥鰌の罪とレズ陵辱	色情
ezgaming	色情
情兽	色情
大 史 紀	色情
税力	色情
发展研究中心	色情
洱	色情
毛小穴	色情
插姐妹小穴	色情
聖火	色情
李克強	色情
成人色情	色情
毛阴唇	色情
毛江泽民	色情
meimei的穴好紧	色情
毛你大爷	色情
涵涵	色情
你馬的	色情
U-R	色情
55sss偷拍区	色情
激情视频女半夜播放成人节目免费裸体视频	色情
粗大肉棒插入蜜穴	色情
新唐人	色情
卖b	色情
西藏獨立	色情
輪奸大meinv	色情
巨炮兵團	色情
督察	色情
毛日gm	色情
淫乱小说	色情
毛反华	色情
法^^論	色情
毛吴邦国	色情
毛性虐待	色情
激情淫色网站	色情
和妹妹肏屄	色情
*法*輪*功*	色情
ｍａｎｋｉｎｄ	色情
普贤	色情
法轮公	色情
成人淫穴导航	色情
淫蕩妖艷女醫生	色情
外@挂	色情
苏兆征	色情
毛刘云山	色情
免费淫电影下载	色情
民族矛盾	色情
暴徒	色情
令人喷血的春宫108姿势	色情
乳罩	色情
嫩嫩 小肉缝 小肉穴	色情
欧美淫女在线看电影	色情
六四回忆录	色情
和两勇男玩18P	色情
宮路ナオミ - 美腳★角度 (超美)	色情
分裂	色情
洪哲胜	色情
打倒	色情
naive	色情
毛轮功	色情
bukakke	色情
操妳全家	色情
機戰	色情
抢 粮 记	色情
和两勇男玩25P	色情
仙境传说	色情
打到共产党	色情
佣兵传说	色情
laqia	色情
干进她穴内的龟头	色情
插入内射	色情
维护	色情
王刚	色情
魏新生	色情
香港激情淫色贴图区	色情
海明威	色情
sm	色情
滾那嗎B	色情
瞒报	色情
握着他的鸡巴上下套弄	色情
大FA弟子	色情
抽插30岁处女meimei淫叫不断	色情
炼功	色情
媽	色情
成人贴图区论坛	色情
舔哥哥鸡巴	色情
电影淫电影艳情电影	色情
鸡芭	色情
毛她妈的	色情
废墟	色情
日本成人激情电影	色情
法^^抡	色情
１９８９ 事件	色情
天下貳	色情
巨乳	色情
淫荡姐姐勾引小弟玩操屄	色情
成人激情色情电影	色情
狗操	色情
damm	色情
那娘錯比	色情
黑鬼	色情
中华大众	色情
淫色网址导航	色情
毛董文华	色情
自插小穴	色情
wg武功	色情
姐弟淫乱小说	色情
消滅共產黨	色情
由喜贵	色情
毛民航局	色情
中年美妇	色情
真主	色情
caobi	色情
Queen8 社长秘书のパンスト	色情
下體	色情
DROP	色情
丰满小妹的丰褪美腿 嫩得流水的小meimei	色情
贱bi	色情
吸精	色情
马卖马屁	色情
大 史 记	色情
毛龟公	色情
翘臀嫩穴	色情
摸阴蒂	色情
賣淫	色情
亚洲电影区	色情
本站10016多部激情电影全部免费试看三天	色情
本站10012多部激情电影全部免费试看	色情
shengda	色情
天龙八部	色情
她妈的	色情
叫鸡	色情
妩媚挑逗	色情
李继耐	色情
本站10019多部激情电影全部免费试看三天	色情
我和小姨淫	色情
抢劫犯	色情
毛洪志	色情
怎样延迟射精23岁以下禁	色情
免费操小姨子 操小姨 操小姐图片	色情
现役看护妇电影下载	色情
妓女自拍做爱电影	色情
狂插小浪穴	色情
手记注册日韩5032部激情电影	色情
黄色小说	色情
毛你二大爷	色情
fuck四人帮	色情
肉棒狂插穴口 ┅好爽┅┅	色情
她妈	色情
马英九	色情
南华早报	色情
ＧＭ	色情
jiaochuang	色情
剑侠情缘OnlineII	色情
淫洞 贴图	色情
gamemaste	色情
二屄	色情
俄罗斯	色情
香港激情淫色贴图网	色情
揚振	色情
鹿城最新导航	色情
現金	色情
激情视频在线	色情
黄色我该死免费淫奸a片偷拍MM接客宾馆	色情
賣QQ	色情
露點	色情
智傲	色情
法仑功	色情
磕药	色情
表姐含我小鸡鸡	色情
和两勇男玩42P	色情
妹妹阴毛	色情
天遊	色情
发~纶	色情
鬼輪奸	色情
私處	色情
大鸡巴	色情
干姐姐小穴	色情
六。四	色情
淫奸meinv穴	色情
摸你全身	色情
夜总会	色情
胡新宇	色情
毛六四真相	色情
ｋａｎｇ ｚｈａｎ	色情
兴奋剂	色情
鸡吧一柱擎天	色情
小穴在上下套动	色情
本站10000多部激情电影全部免费试看	色情
林保华	色情
强奸22岁处女全过程/淫妹阴毛小穴	色情
亚洲激情meimei	色情
免费淫色影院	色情
法囵功	色情
MK 星云	色情
台湾18dy电影	色情
拔出來	色情
女干三亏	色情
淫水翻腾	色情
南京大学法学院	色情
干干	色情
絲襪	色情
激情淫色组图	色情
哭夭	色情
毛六-四	色情
ｍｉｎｈｕｉ	色情
民主党派	色情
少妇做爱小说	色情
绿色數碼	色情
干我	色情
操曹刚川	色情
BT淫穴	色情
电影免费试看片	色情
和平演变	色情
汶川	色情
猥亵	色情
招妓	色情
淫荡少妇极品穴	色情
操嫂嫂	色情
毛主席复活	色情
多維社	色情
小泉恶搞	色情
給處女開苞	色情
meinv直播做爱	色情
外$掛	色情
你说我说论坛	色情
批林批孔	色情
吾尔开希	色情
烟草局	色情
毛妳妈的	色情
毛苹果日报	色情
免费淫色情电影 瞄準她的肉穴插了進去……	色情
色网阴道特写强奸26岁处女全过程	色情
穴太紧了 插进	色情
被干的喷水的高清图	色情
熟女人妻 太太自愿拍片被机射在里面	色情
淋病	色情
功夫小子	色情
愛液橫流	色情
毛静坐	色情
天安门录像带	色情
達賴喇嘛	色情
中公網	色情
佛教	色情
……好舒服 ……好爽	色情
风骚淫荡	色情
手淫	色情
全裸女优	色情
创世之子猎艳之旅	色情
作爱聚会	色情
ｋｏｎｇ ｑｕｅ ｗａｎｇ	色情
国家安全	色情
在线淫电影网站	色情
肉棒捅进阴户里	色情
代理	色情
機巴	色情
大乱交	色情
毛邮政局	色情
内射魅惑の美少女精液滋滋往外冒	色情
操冰毒	色情
秦真	色情
mierda	色情
骚	色情
安理会	色情
triangle	色情
脫內褲	色情
日你祖宗	色情
超美少女系列 蛯原舞	色情
操穴插逼	色情
非洲	色情
fuck温总理	色情
毛妓	色情
酥胸誘惑	色情
倚天二	色情
明慧	色情
黄色淫穴电影	色情
女優	色情
騷穴	色情
杜鲁门	色情
au	色情
FLG妈B发抡	色情
回民暴	色情
發~~輪	色情
肉棒舌頭 蜜穴	色情
日韩激情电影	色情
精液喷射小穴	色情
狂操小姐	色情
meinv性交极品大片	色情
耶苏	色情
肉便器	色情
两岸三地论坛	色情
淫战群p	色情
用你的阴茎插我的阴道	色情
垮臺	色情
食捻屎	色情
日本av	色情
anal	色情
墨索里尼	色情
风骚小阿姨 -新闻	色情
仁寿警方	色情
乱伦淫书成人网	色情
新华举报	色情
巨炮兵团	色情
妳她媽的	色情
美沙酮	色情
靠么	色情
骚妻	色情
男女蒲典	色情
插入处女的肉穴深处	色情
西藏问題	色情
MUGEN EX Vol。 7~滨崎(MX-07)	色情
就去色色	色情
韩正	色情
情色 meinv -公安机关 -记者 -犯罪嫌疑人	色情
fuck台湾狗	色情
剛比	色情
fuck信访局	色情
毛共匪	色情
鸟你	色情
換妻大會	色情
哈宝	色情
我跟妹妹肏穴	色情
f_u_c_k	色情
顏射自拍	色情
wg99	色情
处女开包	色情
毛受虐狂	色情
jiejie的阴户好嫩啊	色情
催眠悪用集団轮奸30连発	色情
他祖宗	色情
哥哥粗大的肉棒	色情
歡迎G10情色電影院	色情
hai zhi yue zhang	色情
生奸內射	色情
娇小鲜嫩的小屄	色情
中国天使成人网我该死免费视频	色情
林樵清	色情
欢城互动	色情
禦の二代目	色情
嘭嘭幫	色情
鸡巴插进娇嫩的花蕊	色情
激情视频聊天室	色情
小姨子她饱满乳峰上的粉红乳晕	色情
学自联	色情
金玉天立	色情
GAME MASTER	色情
插後庭	色情
ｌｏｎｇ ｙｕ ｄｉ ｘｉａ ｃｈｅｎｇ	色情
法^^綸	色情
兆鴻	色情
发@@伦	色情
小瘪三	色情
中國狗	色情
日王	色情
卵	色情
荣毅仁	色情
藏春阁【全免费】	色情
万岁	色情
外-挂	色情
褻	色情
香港GHB水	色情
毛看棋软件	色情
李宏旨	色情
Tora-Tora Platinum Vol。8 宫泽Keito 完全无修正第二弹	色情
Tokyo Hot n0252 : 原田友美 高飞车美人教师精液轰沈	色情
叛国	色情
奶大屄肥	色情
告全体网民书	色情
orgasums	色情
打砲	色情
少妇白洁	色情
发$论	色情
教派	色情
手记注册日韩5028部激情电影	色情
悲惨-双胞胎一起被奸	色情
免费淫电影网	色情
如果你未满30周岁请自觉离开。	色情
聶榮臻	色情
日死	色情
淫女论坛	色情
浪婦	色情
咪咪图片	色情
毛精子	色情
免费淫色贴图	色情
灾区	色情
清华同方	色情
星戰情緣	色情
黑五类	色情
搞大肚婆爽+口交泻水淫图	色情
点击观看*林心如做爱*色情电影*免费淫电影a片	色情
居然花钱请人教性爱姿势(组图)	色情
淫色电影网站	色情
日本情色无码光碟	色情
暴干	色情
插入姐姐蜜穴	色情
狂插 浪穴	色情
藤人	色情
公审江泽民	色情
亚洲有码	色情
捅你	色情
dpp	色情
itembay	色情
毛牛逼	色情
毛威而钢	色情
法婨功	色情
On Air	色情
調理勞務系	色情
女教师禽兽轮奸陷阱	色情
水去车侖	色情
色网阴道特写强奸25岁处女全过程	色情
simple	色情
肉把鸡巴包得紧紧	色情
骚棍	色情
奸淫护士穴	色情
调教	色情
onhave	色情
援交薄码	色情
台湾 18 成人网站	色情
肥东交警	色情
柔软的肉壁紧紧的包著龟头	色情
丁子霖	色情
妈的靠	色情
東突組織	色情
天安門母親	色情
６。４事件	色情
猛将	色情
插 15p	色情
test	色情
系統消息	色情
家庭乱伦小说	色情
毛人民广场	色情
乌兰夫	色情
先烈的电话	色情
輿論鉗制	色情
NPC靠	色情
ｈｅａｔｐｒｏｊｅｃｔ	色情
乳溝	色情
做爱激情小电影	色情
可卡叶	色情
东方互通	色情
毛寇晓伟	色情
水从穴里流出来	色情
血腥冲突	色情
马良骏	色情
9JBW	色情
晚年周恩來	色情
淫色BT娱乐导航	色情
昱泉	色情
倒塌	色情
林心如淫电影	色情
血洒天安门	色情
在线免费观看性感摸特日本性感奶霸图片骚	色情
發~~侖	色情
手记注册日韩5035部激情电影	色情
作愛	色情
党中央	色情
幼女情色论坛	色情
免费色情激情电影网站	色情
10 Little Asians Vol。 14～10人微乳素人娘～	色情
爛貨	色情
淫語連連	色情
毛毛泽东	色情
戴晶	色情
插入小姨的子宫	色情
公子冲	色情
於幼軍	色情
pao pao tang	色情
肉棒噗嗤一声插入阴道	色情
小姨令我射了好几次	色情
玛雅网	色情
令人喷血的春宫108姿势(组图)19岁禁看	色情
二五互联	色情
━	色情
掰开MM嫩穴	色情
美女淫水狂流	色情
百海	色情
港澳成人午夜激情	色情
街头对抗靠	色情
日本插穴	色情
换妻杂交	色情
肉棒插到花心深处	色情
淫穴内好痒	色情
野性家庭女教师	色情
李德生	色情
韩国成人激情影院	色情
阴茎插入少妇阴道	色情
断水	色情
舔奶	色情
发*沦	色情
格老子	色情
免费淫色情电影 教你怎样延迟射精18岁以下禁免费淫电影a片	色情
淫液下留	色情
援助交易	色情
操雞	色情
中國性愛城	色情
韓國三級情色电影	色情
插烂meimei小屄	色情
好色妹妹电影做爱论坛	色情
教你怎样延迟射精26岁以下禁免费淫电影a片	色情
偷窺圖片	色情
少婦偷情	色情
猫扑	色情
老虎机	色情
饱满的乳房肥嫩的阴唇又肥又嫩的小骚屄儿	色情
onair	色情
成人激情聊天室	色情
毛塞你老母	色情
淫妹妹电影	色情
毛破鞋	色情
李大钊	色情
插妹妹淫屄	色情
怎样延迟射精26岁以下禁	色情
毛交通部	色情
近親相姦	色情
89動亂	色情
├	色情
十五周年	色情
和两勇男玩43P	色情
三国世纪	色情
毛烂货	色情
meinv出租车内强行进入	色情
龟头抽插小穴	色情
娼妇	色情
淫色贴图导航	色情
迅雷下载免费淫乱电影	色情
kele8	色情
奴隸調教	色情
双十节	色情
紧紧的小穴	色情
毛靠腰	色情
meimei的屄好紧啊	色情
舔她的小洞洞	色情
成人电影，黄色电影，色情电影，免费电影试看	色情
激情小说	色情
超meinv优MUGEN EX Vol。 7~浜崎ひめ	色情
大陆黄网导航	色情
做爱图	色情
毛世界日报	色情
淫荡护士	色情
長瀨	色情
鸡院	色情
鐵甲爭雄	色情
姐姐的穴夹的我好紧小说	色情
日本女优	色情
好大的肉棒	色情
数通	色情
东南西北论谈	色情
强奸护士	色情
穿豹紋的美女，很有野性美。看她咬著肉根就可看出來。	色情
薑春雲	色情
我和小姨淫穴	色情
嗎逼	色情
激情淫色贴图网址	色情
数据中国	色情
手指用力扣进小穴	色情
meimei的阴道好紧啊	色情
母亲の结婚生活完全版	色情
国外A片电影-美国色情电影一点点激情下载	色情
猪操	色情
免费mm黄色淫乱电影	色情
公交车上淫乱小穴狂插	色情
我淫我色	色情
瘋狂抽送	色情
蒙尘药	色情
┅┅啊┅┅好舒服啊	色情
毛发抡功	色情
国外成人激情网站	色情
免费裸体美女性交电影	色情
傭兵傳說	色情
亚洲美女	色情
刘澜涛	色情
小穴的周围不断地缠绵着	色情
flg	色情
宁王府淫色	色情
jing ling	色情
免费淫女在线看电影	色情
郭伯雄	色情
RED HOT JAM 7 Eeos Note 姬崎水希	色情
短信猫	色情
布雷尔	色情
免费台湾18电影	色情
发轮	色情
hotsex	色情
fuck you	色情
日韩免费成人电影	色情
求自己的爸爸和她干	色情
刘士贤	色情
嚮導	色情
红肿的小穴摩弄	色情
MADELOVE	色情
流星學院	色情
鸡巴 嫩穴 嫩肉	色情
新疆国	色情
淫书	色情
法黁功	色情
痛批政法委	色情
com流氓	色情
移动联通秘密通道	色情
fuck晚年周恩来	色情
日本激情淫色贴图区	色情
强奸46岁处女全过程/淫妹阴毛小穴	色情
日本淫穴电影	色情
舌战法庭	色情
ㄙㄞ你母	色情
僵賊民	色情
操表妹操	色情
亚洲成人激情视频	色情
毛老毛子	色情
毛狗屎	色情
da hua	色情
地下刊物	色情
法~論	色情
fuck系统讯息	色情
色电影	色情
ERA OF FAITH	色情
狂插美女穴	色情
┮	色情
八路	色情
藤武	色情
(桃太郎)ファーストアナル生中出しSpecial 佐藤江梨花 特典	色情
抽插26岁处女meimei淫叫不断	色情
用舌头对着阴道阴蒂等地方用力地舔着	色情
毛你妈	色情
國產偷拍	色情
武雷	色情
肉棒插入肉缝	色情
久游网	色情
日韩淫女	色情
尸虫	色情
毛威而柔	色情
QQ幻想	色情
氯胺酮	色情
你全家	色情
迫奸	色情
fuck外-挂	色情
哥哥淫奸妹妹穴	色情
赵品潞	色情
草枝麻	色情
fku	色情
天鹅绒行动	色情
李 文 斌	色情
廖暉	色情
日本RING	色情
三个呆婊	色情
沾满了淫	色情
撒尿	色情
很黄很暴力	色情
ｋｅ ｌｕｏ ｓｉ	色情
盖世太保	色情
发*抡	色情
快感	色情
龟头插进	色情
jiejie的嫩阴唇	色情
免费我该死淫水流出图	色情
asktao	色情
外挂	色情
民主潮	色情
胡总书记	色情
国 家 安 全	色情
street of EROS 07 小泉リカ	色情
他吗的	色情
插那嗎逼	色情
公交车上操女大学生	色情
法愣	色情
暴动	色情
白石ひより-完全攻略	色情
令人喷血的春宫108姿势(组图)22岁禁看	色情
98bb成人小电影	色情
密室淫行	色情
和姐姐插穴	色情
淫奸表妹	色情
yuanming	色情
色图乡	色情
劍網	色情
新绝代双骄	色情
舌头舔小肉縫	色情
６１０辦公室	色情
欧美靓穴小小论坛帖图母子姐弟淫……男男激情欧美淫贴图	色情
操布莱尔	色情
奸淫少妇穴	色情
Bitch	色情
mm屄	色情
發淪	色情
发$轮	色情
毛人民银行	色情
龟投	色情
龙洲影院日本娱乐性免费电影	色情
ｉ3ｈｕｎ	色情
鸡	色情
愛液	色情
绿色數码	色情
毛退党	色情
贝肉	色情
强奸19岁处女全过程/淫妹阴毛小穴	色情
法@纶	色情
操操gM	色情
乱伦淫穴	色情
色妹妹淫穴	色情
激情女优	色情
肉縫	色情
法^伦	色情
肥西	色情
抗战	色情
u   r靠	色情
亞洲自然超可愛美巨乳	色情
运营组	色情
激情做爱色情淫妇做爱	色情
狂插嫂子穴	色情
操婊	色情
Kurumi	色情
騷母	色情
宫泽Keito 超美系模特儿引退作	色情
死gd	色情
roi world	色情
毛宋祖英	色情
天安门大屠杀	色情
解放军306医院	色情
男女交欢	色情
Tokyo Hot n0232 : 真宫梨沙子	色情
1000y	色情
道教	色情
你祖宗	色情
c a o靠	色情
嫩穴 小穴 花心	色情
fuck驶你老师	色情
淫妹妹	色情
王震	色情
那吗瘟比	色情
操成人片	色情
抢尸	色情
舔蜜穴好爽	色情
王 秀 丽	色情
粉红色的大阴唇正紧紧的闭合着	色情
毛日gM	色情
葵	色情
教你怎样延迟射精20岁以下禁免费淫电影a片	色情
Red Hot Fetish Collection Vol。 34 : Saito真央	色情
日韩淫女电影	色情
色情导航	色情
mi zhuan	色情
初中妹妹的小美穴	色情
猖妓	色情
遊戲幣	色情
無碼炮圖	色情
我要性交	色情
你媽逼	色情
火線任務	色情
程真	色情
成人激情论坛导航	色情
鸡吧猛的抽插嫩穴	色情
操你娘	色情
美女嫂子的小骚逼	色情
肉棒插入穴中	色情
母子乱伦之淫穴	色情
嫩女	色情
百家性黄站	色情
胸罩	色情
滕仁	色情
温元凯	色情
淫荡美眉就喜欢玩男人	色情
赤裸天使	色情
minghui	色情
女馬	色情
毛军长发威	色情
ｒｆ 行会战争	色情
曹庆泽	色情
肛门喷水	色情
反右题材	色情
penis	色情
陰阜高聳	色情
皮條客	色情
巨騷	色情
╋	色情
大卫教	色情
没有人权	色情
爱液横流	色情
毛国安局	色情
许世友	色情
拿破仑	色情
汉 奸	色情
抽插33岁处女妹妹淫叫不断	色情
傻b	色情
浩天银科	色情
魏 新 生	色情
鸡吧插进肉穴	色情
肉棍 嫩穴 肉洞	色情
basterd	色情
日你娘	色情
教你怎样延迟射精36岁以下禁免费淫电影a片	色情
足腳交	色情
18dy	色情
浪少妇和医生疯狂做爱	色情
反封鎖技術	色情
台聯黨	色情
白虎少婦	色情
插的meimei好爽啊	色情
近親相奸	色情
淫荡少妇穴	色情
免注册淫电影在线观看	色情
mwo	色情
毛欢城	色情
周总理	色情
酥胸诱惑	色情
毛狗b	色情
f a l u n d a f a	色情
ｔｉｅ ｘｕｅ ｓａｎ ｇｕｏ ｚｈｉ	色情
奸淫嫂嫂	色情
曰	色情
阴茎把淫穴塞满	色情
妈批	色情
抽插28岁处女妹妹淫叫不断	色情
法轮大法	色情
藏妇会	色情
肉棒抽插…不要	色情
碧香亭	色情
慰	色情
色狼論壇	色情
骚妹爽图	色情
肉棒入少妇嫩穴嫩穴	色情
天之游侠	色情
浪妇	色情
自制手枪	色情
MM的小嫩穴	色情
美女鸡吧图	色情
又肥又紧的屄	色情
窝窝客	色情
毛血逼	色情
又骚又大的屄	色情
小阴唇被鸡巴猛的塞进去	色情
法$倫	色情
大参考	色情
白虎嫩b	色情
操淫荡 极品嫩穴操淫荡少妇	色情
洗腦班	色情
封杀	色情
成人书库	色情
朱林	色情
周永康	色情
粉嫩粉嫩的小穴流水	色情
肉棒插入小穴	色情
易丹轩	色情
私？服	色情
血腥图片	色情
少妇操b图 操农村少妇 少妇操尿图	色情
又大又肥的阴道	色情
咪咪圖片	色情
肉棒插进阴道里	色情
支持达賴	色情
鹿城娛樂	色情
大鸡巴狠插小穴	色情
无网界	色情
毛军委	色情
日本鬼子	色情
激情淫窟	色情
Vol。 17 ~巨乳美熟女	色情
陽物	色情
厕所性感meinv清晰淫穴	色情
代练	色情
激情交友	色情
現金交易	色情
遊戲指導員	色情
江山美人志	色情
人妻阴穴	色情
在乳房和阴道摸弄	色情
77bbb	色情
把肉棒抽出来	色情
Jap Jap	色情
耶稣	色情
姨妈和我乱伦理小说	色情
本站10012多部激情电影全部免费试看三天	色情
毛性无能	色情
無碼小處女	色情
肉棒插进阴户内	色情
fuck税务总局	色情
鸡吧插进肥嫩的小骚屄	色情
運营者	色情
龟头顺着肉壁插入她的阴户	色情
毛黄　菊	色情
你呀的鸡巴长歪了吧	色情
下阴	色情
米开朗基罗	色情
浴室自拍	色情
jiangshan	色情
曹长青	色情
妖媚熟母	色情
毛泽东	色情
欢乐城美国在线 咪咪爱论坛	色情
大奶美逼	色情
fuck洗脑班	色情
狂插美少女穴	色情
四人帮	色情
工作人员	色情
毛游行	色情
林心如做爱网有激情自拍裸体	色情
陈独秀	色情
导航色站	色情
小穴 双手紧抓住 丰臀	色情
網路公祭	色情
淫乱插穴好爽	色情
成人娱乐网	色情
龔學平	色情
吞食天地	色情
寻仙	色情
激情淫bb	色情
りすぎ家庭教師 ほしのキララ	色情
chinamz	色情
检查	色情
免费色情电影	色情
免费电影 meinv电影	色情
他ㄇ的	色情
司徒华	色情
网絡公祭	色情
vip在线成人电影	色情
色情电影	色情
毛淫欲	色情
15年前的“共和国卫士”	色情
可卡葉	色情
操陈晓宁	色情
生命奇迹	色情
94bb成人小电影	色情
毛卖QQ	色情
ｇａｍｅ　ＭＡＳＴＥＲ	色情
快乐AV	色情
付申奇	色情
法埨功	色情
动漫激情淫色贴图	色情
迟浩田	色情
毛法西斯	色情
内挂	色情
共青团员	色情
摸咪咪	色情
经血	色情
啊┅┅用力┅┅用力插烂我的淫穴	色情
少林傳奇	色情
香港淫穴	色情
同性戀	色情
多人性愛	色情
田紀云	色情
温州黄站	色情
人妻熟女	色情
特别公告	色情
巡府媳	色情
曾 庆 红	色情
给你爽	色情
密碼	色情
刘千石	色情
硅谷动力	色情
dfdz	色情
干进妹妹的小穴	色情
毛社科院	色情
厕所盗摄美女	色情
日本AV女优	色情
干进meimei的小穴	色情
淫荡美少女	色情
Tora Tora Gold Vol。16 香山圣	色情
淫师荡母	色情
台湾建国	色情
淫乱秘史	色情
先审后贴	色情
大波骚妇	色情
激情淫穴网站	色情
黄色性交裸体图_做爱贴图性交成人贴图	色情
lisishijian	色情
色链	色情
操你媽的	色情
妹妹的小屄好痒	色情
淫荡校妓	色情
粉紅穴	色情
區	色情
ｗａｉ ｇｕａ	色情
毛公安局	色情
情色激情论坛	色情
徐匡迪	色情
姚月谦	色情
客服	色情
fuck天安门	色情
胡锦涛	色情
湿身诱惑	色情
ｗａｎ ｍｅｉ ｓｈｉ ｊｉｅ	色情
子宮	色情
劳动教养所	色情
傻逼	色情
免费裸女视频聊天	色情
司馬義•鉄力瓦爾地	色情
香港激情淫影院	色情
水去车仑	色情
前凸后翘	色情
迷歼药	色情
可待因	色情
干娘	色情
林心如合成淫照图片林心如淫照图片	色情
外**挂	色情
欧美激情淫色下载	色情
Gate To Heavens	色情
Tokyo Hot n0156~160合集收藏版	色情
富豪们的疯狂做/爱方式	色情
操你八輩祖宗	色情
伸入jiejie裙内	色情
女教师家访遭遇体剃毛内射肛交口爆喷尿虐待	色情
一夜情	色情
浴尿	色情
激情成人午夜	色情
大鸡巴 插入 肉缝	色情
阿姨的阴户好大啊	色情
品香堂	色情
我靠	色情
纳粹	色情
fuck傻逼	色情
江八點	色情
插婷婷小穴	色情
毛外交部	色情
阳具在阴道里来回抽插	色情
文九天	色情
雪山狮子	色情
操meinv穴	色情
高　潮　喷精	色情
如果你未满18周岁请自觉离开。	色情
神之領域	色情
item	色情
又深又紧的阴户	色情
中年美婦	色情
骚女淫频乐园	色情
淫色少妇做爱淫穴流	色情
砍翻一條街	色情
毛劳动保障部	色情
操B指南	色情
本站10011多部激情电影全部免费试看	色情
淫穴更紧紧将我的肉棒吸住	色情
干穴	色情
蜜穴	色情
發^掄	色情
办理文凭	色情
d7se淫色穴图片和美女发春激情3级片试看	色情
杨振	色情
chuan shuo	色情
哥哥我爽晕了	色情
淫賤少女	色情
淫奸处女穴电影	色情
你爷爷的	色情
*李*洪*志*	色情
如果你未满26周岁请自觉离开。	色情
死刑过程	色情
戳那嗎逼	色情
互联经纬	色情
经插进我的穴了	色情
法$$論	色情
毛妳马的	色情
小澤瑪利亞~~誘惑色情	色情
超毛大鲍	色情
國民黨萬歲	色情
╃	色情
免费淫色电影网站	色情
毛法功	色情
黄色三级片	色情
ｙｉｎｇ ｘｉｏｎｇ ｗａｎｇ ｚｕｏ	色情
妹妹的嫩阴唇	色情
meimei小穴	色情
幸运抽奖管理小组	色情
三男轮番干一个荡妇	色情
干 淫洞	色情
肥嫩的阴穴	色情
三去車仑	色情
宋xx	色情
幹砲	色情
魔力宝贝	色情
打野炮	色情
大法	色情
fuck食捻屎	色情
阴道里的大肉棒来回抽插	色情
父女激情淫色文章	色情
大陆娱乐鹿城黄站	色情
高丽朴	色情
法稐功	色情
真理组织	色情
女性私处锻炼法	色情
劍俠世界	色情
开放杂志	色情
fuck私-服	色情
道县公安	色情
毛原子能机构	色情
岩崎 Sky Angel Vol。27	色情
毛法轮	色情
毛温馨	色情
射爽	色情
18男人摸摸B	色情
爽死我了	色情
hang hai shi ji	色情
他妈靠	色情
大鸡巴坚挺插淫穴	色情
总统的讲话	色情
白漿四濺	色情
ㄐ八	色情
fuck手淫	色情
中广网	色情
meinv 淫穴	色情
ｚｈｅｎｇ ｆｕ	色情
蒋彦勇上书	色情
鳥gm	色情
The Best by Private 71: The Best Little Horny Asians	色情
纶功	色情
台湾	色情
最新 Queen8 无修正素人	色情
我的阴茎使劲的抽插她的小穴	色情
机掰	色情
贾廷安	色情
14色se成人站	色情
钓鱼岛	色情
肉棒狠狠地插进小淫穴中	色情
大眾色情成人網	色情
郭平	色情
处女被强迫吃春药后被开苞	色情
大腿	色情
毛懂文华	色情
八 仙靠	色情
美骚妇	色情
廁奴	色情
方毅	色情
b毛	色情
预测	色情
台湾盲人meinv在家疯狂做爱	色情
陈云	色情
少妇房中自淫	色情
麻醉乙醚	色情
六四屠城	色情
毛管理人员	色情
姘头	色情
手记注册日韩5003部激情电影	色情
市长	色情
你姥	色情
朱总理	色情
骚卵	色情
硬挺	色情
肉棒插进阴户里	色情
毛基地组织	色情
粗鸡巴 嫩穴	色情
抽插53岁处女妹妹淫叫不断	色情
性感妖娆	色情
沈阳公安	色情
干妳妈	色情
午夜激情剧场	色情
rivals靠	色情
在线淫电影 看完保证你打飞机	色情
日你老娘	色情
18dy影院	色情
钱国梁	色情
毛新手指导员	色情
164网址宽频影院网	色情
干jiejie小穴	色情
jin wu shi jie	色情
嫩穴 插干 …快插我吧	色情
成人黄色网站	色情
湿了	色情
打砸抢	色情
妹妹的阴道好嫩啊	色情
滥货	色情
小阴唇 黏液流下 舌头舔进阴道	色情
dajiyuan	色情
毛天安门一代	色情
蒙古獨立	色情
發綸	色情
手记注册日韩5033部激情电影	色情
96bb成人小电影	色情
毛狗娘	色情
哥哥	色情
免费电影現役看護婦	色情
勁樂	色情
日本无码成人电影	色情
情色文學	色情
朱容基	色情
小穴流水meimei手指插	色情
huo xian ren wu	色情
gang jia hong liu	色情
meinv淫色贴图区	色情
办理证件	色情
完全免费在线淫电影？	色情
糖糖小穴	色情
apesoft	色情
日本人淫乱操淫荡少妇操淫荡妹妹	色情
杨巍	色情
颜色革命	色情
猛干	色情
Tora-Tora Platinum Vol。11 持田茜	色情
肉棒抵住阴唇 插入	色情
萨拉托加	色情
ｈｕａ ｈｕａ ｍａｎ	色情
淫女穴影院	色情
zhengjianwang	色情
错那吗逼	色情
妈的穴让你插	色情
战牌	色情
我淫我色导航	色情
吳桂賢	色情
麦角酸二乙基酰胺	色情
肉棒的抽插……干的好爽	色情
囘良玉	色情
李 瑞 环	色情
ｆｒｅｅ ｓｔｙｌｅ	色情
下三爛	色情
奸染	色情
社保基金会	色情
丝袜	色情
奧美電子	色情
Pink Puncher~生中出SEX Ais Cumshot Inside Sex !! : 姬野爱	色情
hanbiton	色情
8仙靠	色情
穆罕默德	色情
正悟網	色情
儂著卵拋	色情
目标软件	色情
虎门	色情
rx008	色情
采花堂	色情
劍網3	色情
氵去车仑工力	色情
Red Hot Jam Vol。10 高树圣良	色情
日本激情淫色	色情
淫女性息	色情
狗诚	色情
私/服	色情
洪吟	色情
支那	色情
又骚又淫的屄	色情
情色聊天室	色情
激情成人网 -用品 -知识 -保健	色情
娄义	色情
ur靠	色情
中国激情淫色贴图	色情
免费观看美女裸体贴图	色情
日蛋	色情
小淫虫电影	色情
Neko GN Vol。1潮姬 史上最高之潮吹少女	色情
免费淫奸女Ａ片段试看 居然花钱请人教性爱姿势	色情
中国人民志愿军	色情
肉棒压着阴蒂	色情
淫荡少女穴	色情
斧头镰刀	色情
汤光中	色情
臭鸡	色情
熊炎	色情
真理組織	色情
兽奸	色情
捅他	色情
抽插 磨蹭 穴 B 逼	色情
ｔｈｅ ｗｏｒｌｄ ｏｆ ｌｅｇｅｎｄ	色情
反社會	色情
89bb成人小电影	色情
富人与农民工	色情
谋杀	色情
发@论	色情
┾	色情
日本無碼o ~幼齒女學生	色情
yeeplay	色情
毛日Gm	色情
幸存	色情
台獨分子	色情
强奸处女学妹	色情
掛	色情
2。23会议	色情
你娘卡好	色情
我的性启蒙老师	色情
h站	色情
后备专员	色情
狂插小浪妹	色情
阴茎在子宫喷射黏液	色情
中国淫女论坛	色情
最新99bb)有名女优~松岛やや	色情
piao piao	色情
SB	色情
小骚娘们的小嫩骚屄	色情
精子射到姐姐的穴里	色情
厕所盗摄meinv	色情
圣角色扮演学园~大泽萌	色情
男女激情淫乱图片穴	色情
┿	色情
游戏管理员	色情
CCTV	色情
老b	色情
大陆免费黄站	色情
手机注册电影	色情
wtf	色情
上海孤儿院	色情
少妇床上的激情	色情
陈毅	色情
李师付	色情
日本情色电影	色情
機吧	色情
阿片烟	色情
顶进少妇的花心	色情
ｈａｉ ｄａｏ ｗａｎｇ	色情
黄色图片	色情
迅雷下载免费黄色淫乱电影	色情
那嗎瘟比	色情
成人激情网站大全	色情
性無能	色情
你老味	色情
男人最爱的淫图	色情
中文搜性网	色情
毛我妳老爸	色情
高治联	色情
法$$伦	色情
毛高校骚乱	色情
公审李鹏	色情
激情热舞	色情
媽的	色情
掌上灵通	色情
壮汉给纯情处女开苞	色情
彭真	色情
………好舒服喔	色情
和两勇男玩33P	色情
強姦犯	色情
狂插老师穴	色情
騷B熟女	色情
毛公安部	色情
怎么能知道女性手淫过	色情
国产经典 - 4级红楼梦！【wm/113MB】	色情
抽插31岁处女妹妹淫叫不断	色情
强奸你	色情
淫奸姐姐论坛	色情
成人午夜剧场	色情
蜜穴裡輕插緩送	色情
法lun功	暴恐
乏抡	暴恐
售五四	暴恐
Flg	暴恐
发瞟	暴恐
虹志	暴恐
集体自杀	暴恐
发论	暴恐
珐纶	暴恐
枪模	暴恐
发沦	暴恐
法轮功	暴恐
弟子	暴恐
明慧网	暴恐
罚囵	暴恐
砝沦	暴恐
titor	暴恐
乏沦	暴恐
泓志	暴恐
罚仑	暴恐
垡仑	暴恐
乏仑	暴恐
售狗子	暴恐
法抡	暴恐
梦网洪志	暴恐
垡沦	暴恐
阀纶	暴恐
发纶	暴恐
售健卫	暴恐
正见网	暴恐
售猎枪	暴恐
售氯胺	暴恐
阀伦	暴恐
falu	暴恐
阀抡	暴恐
珐.輪功	暴恐
法愣	暴恐
falun	暴恐
电话追杀系统	暴恐
jiuping	暴恐
9评	暴恐
逢八必灾	暴恐
诸世纪	暴恐
乏伦	暴恐
砝伦	暴恐
经文	暴恐
清海无上师	暴恐
达赖喇嘛	暴恐
推bei图	暴恐
dpp大法	暴恐
盘古	暴恐
电话窃听	暴恐
罚伦	暴恐
轮子功	暴恐
筏抡	暴恐
发伦功	暴恐
罚纶	暴恐
伐轮	暴恐
法伦	暴恐
法囵	暴恐
法x功	暴恐
逢9必乱	暴恐
售单管	暴恐
发正念	暴恐
车仑工力	暴恐
法0功	暴恐
原装弹	暴恐
售假币	暴恐
垡囵	暴恐
砝囵	暴恐
售军用	暴恐
五不争鸣论坛	暴恐
法lun	暴恐
李洪志	暴恐
枪械制	暴恐
按照马雅历法	暴恐
五不	暴恐
观音法门	暴恐
珐沦	暴恐
法谪功	暴恐
筏沦	暴恐
法论	暴恐
洪传	暴恐
电击枪	暴恐
转法轮	暴恐
珐囵	暴恐
真善忍	暴恐
轮法功	暴恐
真善美	暴恐
售火药	暴恐
地下教会	暴恐
筏轮	暴恐
洪志	暴恐
藏字石	暴恐
枪手	暴恐
售虎头	暴恐
垡论	暴恐
闳志	暴恐
电话监	暴恐
李宏志	暴恐
五出三进	暴恐
三唑仑	暴恐
逢8必灾	暴恐
中国教徒	暴恐
9ping	暴恐
法正	暴恐
dajiyuan	暴恐
珐抡	暴恐
茳澤民	暴恐
法功	暴恐
法o功	暴恐
珐论	暴恐
超越红墙	暴恐
法lg	暴恐
抡功	暴恐
车仑	暴恐
发抡功	暴恐
新唐人	暴恐
电鸡	暴恐
诺查丹玛斯	暴恐
推背图	暴恐
九评	暴恐
氵去车仑	暴恐
fa lun	暴恐
法轮佛法	暴恐
闵维方	暴恐
Falundafa	暴恐
阀沦	暴恐
售纯度	暴恐
志洪李	暴恐
枪决女犯	暴恐
售手枪	暴恐
乏纶	暴恐
售一元硬	暴恐
法.轮.功	暴恐
法谪	暴恐
法輪	暴恐
砝论	暴恐
发论公	暴恐
枪出售	暴恐
退党	暴恐
法十轮十功	暴恐
退dang	暴恐
福音会	暴恐
筏论	暴恐
枪的制	暴恐
法会	暴恐
洪哲胜	暴恐
法西斯	暴恐
枪销售	暴恐
筏伦	暴恐
朱瑟里诺	暴恐
氵去车仑工力	暴恐
fl功	暴恐
明慧周报	暴恐
光祖	暴恐
洪吟	暴恐
电话交友	暴恐
鸿志	暴恐
珐伦	暴恐
氵去	暴恐
原子弹清单	暴恐
电狗	暴恐
乏轮	暴恐
逢九必乱	暴恐
售子弹	暴恐
法*功	暴恐
自sha	暴恐
伐沦	暴恐
炼功	暴恐
大纪元	暴恐
法院	暴恐
自fen	暴恐
阀仑	暴恐
电警棒	暴恐
suicide	暴恐
发论功	暴恐
筏纶	暴恐
真理教	暴恐
垡轮	暴恐
车库	暴恐
珐轮	暴恐
宏法	暴恐
乏论	暴恐
筏囵	暴恐
发论工	暴恐
法仑	暴恐
人类灭亡进程表	暴恐
法L功	暴恐
五套功法	暴恐
垡伦	暴恐
falungong	暴恐
弘志	暴恐
三水法轮	暴恐
发伦	暴恐
下法轮	暴恐
法一轮一功	暴恐
贯通两极法	暴恐
阀囵	暴恐
售麻醉	暴恐
砝纶	暴恐
珐仑	暴恐
垡纶	暴恐
砝抡	暴恐
砝轮	暴恐
flg	暴恐
济世灵文	暴恐
电话定位器	暴恐
电话拦截器	暴恐
售步枪	暴恐
售枪支	暴恐
售热武	暴恐
伐抡	暴恐
屙民	暴恐
红志	暴恐
邝锦文	暴恐
发轮	暴恐
阀论	暴恐
伦功	暴恐
伐囵	暴恐
宏志	暴恐
轮大	暴恐
枪子弹	暴恐
售弹簧刀	暴恐
法轮大法	暴恐
发囵	暴恐
三去车仑	暴恐
大法弟子	暴恐
原子弹方法	暴恐
法沦	暴恐
筏仑	暴恐
售左轮	暴恐
轮功	暴恐
fa轮	暴恐
荭志	暴恐
法 轮 功	暴恐
九ping	暴恐
洗脑	暴恐
罚沦	暴恐
乏囵	暴恐
法纶	暴恐
zi杀	暴恐
伪火	暴恐
售防身	暴恐
垡抡	暴恐
法抡功	暴恐
售三棱	暴恐
法轮	暴恐
tuidang	暴恐
发仑	暴恐
伐论	暴恐
砝仑	暴恐
罚抡	暴恐
枪货到	暴恐
发抡	暴恐
伐伦	暴恐
大法	暴恐
根达亚文明	暴恐
伐仑	暴恐
统一教	暴恐
真、善、忍	暴恐
发愣	暴恐
凯他敏	毒品
甲基安非他明	毒品
莫达非尼	毒品
氧氯化磷	毒品
mdma	毒品
地塞米松	毒品
androst	毒品
新型毒品	毒品
麻黄草	毒品
k粉	毒品
摇头丸	毒品
氧化铊	毒品
迷药	毒品
海luo因	毒品
麻醉药	毒品
diacetylmorphine	毒品
冰毒	毒品
西布曲明	毒品
strychnine	毒品
兴奋剂	毒品
雄烯二醇	毒品
胰岛素样生长因子	毒品
亚硒酸氢钠	毒品
亚砷酸钾	毒品
三唑仑	毒品
代血浆	毒品
安眠酮	毒品
地奈德	毒品
海洛因	毒品
diamorphine	毒品
亚硝酰乙氧	毒品
tamoxifen	毒品
美沙酮	毒品
爱他死	毒品
呋塞米	毒品
乖乖粉	毒品
麻古	毒品
苯丙胺	毒品
氧化亚铊	毒品
大麻	毒品
adrenaline	毒品
亚硒酸镁	毒品
甲睾酮	毒品
morphine	毒品
testosterone	毒品
地西泮	毒品
促红细胞生成素	毒品
促性腺激素	毒品
苯巴比妥	毒品
杜冷丁	毒品
heroin	毒品
亚硒酸钠	毒品
泼尼松	毒品
鸦片	毒品
安非他命	毒品
代药物毒品类：血浆	毒品
亚硒酸二钠	毒品
氧化汞	毒品
咖啡因	毒品
cocain	毒品
氧化二丁基锡	毒品
尼可刹米	毒品
ketamine	毒品
氯噻嗪	毒品
阿芙蓉	毒品
cannabis	毒品
吗啡	毒品
亚砷（酸）酐	毒品
narcotic	毒品
亚硒酸	毒品
亚硝酸乙酯	毒品
erythropoietin	毒品
氯胺酮	毒品
benzodiazepines	毒品
精神药品	毒品
亚砷酸钠	毒品
普萘洛尔	毒品
腾讯客服电话	其它
买小车	其它
无网界	其它
完全自杀手册	其它
款到发货	其它
6位qq	其它
代追债	其它
杨j	其它
短信群发器	其它
信用卡提现	其它
麦当劳被砸	其它
无界浏览器	其它
资金短缺	其它
易达网络卡	其它
提前预测	其它
考前预测	其它
六合彩	其它
考试联盟	其它
龙小霞	其它
清仓	其它
拆迁	其它
凹晕	其它
客户端非法字符	其它
全1球通	其它
免费二级域名	其它
考联盟	其它
复制	其它
孔丹	其它
原音铃声	其它
王奉友	其它
代办制	其它
无界	其它
详情请进入	其它
罢工	其它
地震预测	其它
钓鱼岛	其它
代讨债	其它
四海帮	其它
股市圈钱	其它
小额贷款	其它
震其国土	其它
代理票据	其它
贺立旗	其它
代写毕	其它
考前答案	其它
零八奥运艰	其它
航空售票	其它
骂四川	其它
替考试	其它
杀警	其它
yuce	其它
KC网站	其它
答案卫星接收机	其它
代表烦	其它
联通贵宾卡	其它
恭喜您的号码	其它
隐瞒地震	其它
透视功能	其它
透视药	其它
短信商务广告	其它
恭喜你的号码	其它
全集在线	其它
曾道人	其它
找个妈妈	其它
盗窃	其它
航空母舰	其它
蟾蜍迁徙	其它
免费订购热线	其它
考前密卷	其它
高利贷	其它
各个银行全称	其它
售肾	其它
下载速度	其它
个qb	其它
打人	其它
打死经过	其它
杨树宽	其它
wengan	其它
代办发票	其它
武侯祠	其它
钓鱼台	其它
加了服	其它
讨回工资	其它
饭菜涨价	其它
调查婚外情	其它
惨奥	其它
懊孕	其它
高官互调	其它
UP8新势力	其它
帮忙点下	其它
透视眼镜	其它
玛雅网	其它
尹方明	其它
代办学	其它
喝一送一	其它
针孔摄象	其它
诚信通手机商城	其它
回复可见	其它
瘟疫爆发	其它
小6灵通	其它
联总这声传单	其它
传单	其它
考后付款	其它
打砸抢	其它
无抵押贷款	其它
段录定	其它
出售答案	其它
地下钱庄	其它
高薪养廉	其它
考试,作弊器	其它
免费使用	其它
代办文	其它
考试作弊	其它
电脑传讯	其它
视频来源	其它
透视器	其它
监听王	其它
网关	其它
y佳	其它
李四光预测	其它
新疆骚乱	其它
成本价	其它
送qb	其它
这不是天灾	其它
隐形耳机	其它
代考	其它
代开发票	其它
打死人	其它
销售热线	其它
崩盘	其它
资金周转	其它
代写论文	其它
考试机构	其它
大麻油	其它
代孕妈妈	其它
张丹红	其它
打砸办公	其它
代生孩子	其它
私家侦探	其它
灵动卡	其它
卡号	其它
yang佳	其它
考研考中	其它
刻章	其它
px项目	其它
救市	其它
黑手党	其它
借腹生子	其它
加盟连锁	其它
套牌车	其它
白皮书	其它
当官靠后台	其它
移民	其它
中印边界谈判结果	其它
懊运	其它
蚁力神	其它
高清在线	其它
奥你妈的运	其它
安魂网	其它
75事件	其它
无帮国	其它
联总之声传单	其它
628事件	其它
万里大造林	其它
低价出售	其它
考试枪	其它
高官	其它
地震来得更猛烈	其它
聂树斌	其它
改卷内幕	其它
答an	其它
中国复兴党	其它
李树菲	其它
黑庄	其它
罢课	其它
短信广告	其它
高息贷款	其它
如6意通	其它
yangjia	其它
旦科	其它
家l福	其它
免费索取	其它
私人侦探	其它
考试,答案	其它
传九促三	其它
KC提示	其它
大麻树脂	其它
用刀横向切腹	其它
摸nai门	其它
川b26931	其它
证监会	其它
六位qq	其它
考考邓	其它
袭警	其它
KC嘉年华	其它
陈相贵	其它
在线播放	其它
食堂涨价	其它
专业代理	其它
连锁加盟	其它
刘明康	其它
da案	其它
打针	其它
豆腐渣	其它
奥晕	其它
透视扑	其它
黑车	其它
广告代理	其它
杨佳	其它
透视镜	其它
考试保	其它
纽崔莱七折	其它
喂奶门	其它
透视眼睛	其它
无网界浏览	其它
尚福林	其它
周正毅	其它
KC短信	其它
号码百事通	其它
位的qq	其它
手机铃声	其它
瓮安事件	其它
化工厂爆炸	其它
代開	其它
代理发票	其它
weng安	其它
txt下载	其它
翁安	其它
联4通	其它
纠纷	其它
请点击进入	其它
乌鲁木齐	其它
找个爸爸	其它
高干子弟	其它
手机复制	其它
质押贷款	其它
踩踏事故	其它
考机构	其它
反奥	其它
短信群发	其它
考前发放	其它
高官子女	其它
考中答案	其它
汉芯造假	其它
代辦	其它
代您考	其它
酒瓶门	其它
考试答案	其它
无界浏览	其它
考试包过	其它
佳静安定片	其它
各种发票	其它
家le福	其它
h1n1	其它
奥孕	其它
代孕	其它
帮忙点一下	其它
透视仪	其它
UP新势力	其它
党校安插亲信	其它
刻章办	其它
婴儿汤	其它
阿波罗网	其它
考试作弊器	其它
针刺	其它
神通加持法	其它
高干子女	其它
考前付	其它
脱裤门	其它
代办各	其它
八级地震毫无预报	其它
足球投注	其它
周小川	其它
联总	其它
潮喷	色情
寂寞女	色情
一本道	色情
幼交	色情
性息	色情
阴茎	色情
下贱	色情
寂寞男	色情
蜜液	色情
麻痹的	色情
性虐	色情
调教	色情
成人游戏	色情
巨屌	色情
国产av	色情
淫女	色情
干你娘	色情
淫荡照片	色情
三级片	色情
amateur	色情
淫媚	色情
操你祖宗	色情
肉缝	色情
性交	色情
成人网站	色情
阴道	色情
屁股	色情
草你丫	色情
大乳	色情
成人文学	色情
g点	色情
色情小说	色情
迷幻药	色情
玉乳	色情
美女裸体	色情
装b	色情
肛门	色情
抓胸	色情
淫贱	色情
伦理毛	色情
色色	色情
淫教师	色情
cao你	色情
大力抽送	色情
贱比	色情
操逼	色情
酥痒	色情
摇头丸	色情
插进	色情
处男	色情
屁眼	色情
阉割	色情
sm女王	色情
穴口	色情
骚妇	色情
色情影片	色情
成人论坛	色情
呻吟	色情
菊花洞	色情
你妈逼	色情
炮友	色情
激情	色情
无码	色情
暴淫	色情
爱液	色情
做爱	色情
擦你妈	色情
要射了	色情
迷情药	色情
口交	色情
sexinsex	色情
全家死光	色情
别他吗	色情
精神药品	色情
风月大陆	色情
被干	色情
男奴	色情
混蛋	色情
淫娃	色情
浪叫	色情
肥逼	色情
hardcore	色情
美幼	色情
裸聊网	色情
狗娘养	色情
伦理片	色情
屌	色情
真他妈	色情
迷魂藥	色情
麻醉药	色情
射精	色情
铃木麻	色情
a4y	色情
摸奶	色情
裸聊	色情
淫穴	色情
你麻痹	色情
成人小说	色情
乳头	色情
xiao77	色情
淫情	色情
你吗b	色情
被操	色情
插逼	色情
轮奸	色情
玉穴	色情
incest	色情
捏弄	色情
熟女	色情
性交图片	色情
欲火	色情
性奴	色情
口活	色情
成人聊	色情
色妹妹	色情
夏川纯	色情
肉具	色情
乱奸	色情
暴奸	色情
色情表演	色情
食精	色情
浑圆	色情
写真	色情
女优	色情
阴毛	色情
吃精	色情
淫书	色情
爆草	色情
轮操	色情
拳交	色情
贱人	色情
淫魔舞	色情
色视频	色情
色电影	色情
曹尼玛	色情
欲女	色情
按摩	色情
成人小	色情
熟妇	色情
就去日	色情
裸露	色情
强奸处女	色情
杀b	色情
人渣	色情
陰戶	色情
强奸	色情
gay片	色情
熟母	色情
tokyohot	色情
淫亵	色情
裸体写真	色情
性伴侣	色情
g片	色情
迷药	色情
铃声	色情
乱伦类	色情
快感	色情
摸胸	色情
媚外	色情
成人电影	色情
黄片	色情
几吧	色情
淫色	色情
煞逼	色情
操你大爷	色情
淫情女	色情
内裤	色情
morphine	色情
美女写真	色情
浪女	色情
狗草	色情
肉棒	色情
艹你	色情
secom	色情
一ye情	色情
a片	色情
欠干	色情
xing伴侣	色情
性奴集中营	色情
煞笔	色情
骚穴	色情
色b	色情
流淫	色情
伦理电影	色情
包二奶	色情
色小说	色情
死全家	色情
插我	色情
肉棍	色情
赤裸	色情
操你妈	色情
sb	色情
肉唇	色情
粉穴	色情
鸡巴	色情
狂操	色情
阴茎增大	色情
惹火身材	色情
陰唇	色情
发生关系	色情
鸡吧	色情
迷幻藥	色情
狗日的	色情
性技巧	色情
高潮	色情
迷魂香	色情
干你妈	色情
舔脚	色情
迷昏药	色情
18禁	色情
漏乳	色情
嫩逼	色情
性伙伴	色情
后穴	色情
少修正	色情
松岛枫	色情
兽性	色情
迷藥	色情
乳房	色情
日逼	色情
拔出来	色情
荡妇	色情
操我	色情
粉嫩	色情
干死	色情
肏死	色情
谜奸药	色情
草你吗	色情
校鸡	色情
被插	色情
淫兽学园	色情
诱奸	色情
密穴	色情
操你娘	色情
妈了个逼	色情
你他妈	色情
幼女	色情
嫩女	色情
插暴	色情
群交	色情
迷魂药	色情
美乳	色情
裹本	色情
口淫	色情
乱伦小	色情
大sb	色情
发浪	色情
菊门	色情
人兽	色情
露b	色情
裙中性运动	色情
花花公子	色情
妓女	色情
淫魔	色情
操烂	色情
杨思敏	色情
无修正	色情
成人视	色情
屄	色情
精子	色情
性饥渴	色情
傻b	色情
盗撮	色情
阴蒂	色情
应召	色情
性服务	色情
色情片	色情
婊子养的	色情
成人文	色情
贱货	色情
好嫩	色情
小xue	色情
草你妈	色情
我日你	色情
性交视频	色情
性感少	色情
贱b	色情
美女上门	色情
美少妇	色情
释欲	色情
淫肉	色情
爆乳	色情
封面女郎	色情
浪妇	色情
乖乖粉	色情
强jian	色情
肉洞	色情
全家死绝	色情
白嫩	色情
阴b	色情
日你妈	色情
淫兽学	色情
阴茎助勃	色情
潮吹	色情
偷欢	色情
色情图片	色情
凌辱	色情
援交	色情
喷精	色情
艹你妈	色情
射颜	色情
淫乱	色情
舔阴	色情
口射	色情
兽交	色情
迷奸	色情
内射	色情
性欲	色情
陰道	色情
淫靡	色情
插你	色情
穴图	色情
大波	色情
欲仙欲死	色情
淫妇	色情
美穴	色情
性虎	色情
一夜欢	色情
成人卡通	色情
淫河	色情
肛交	色情
淫兽	色情
阳具	色情
阴部	色情
肏你	色情
淫虫	色情
体奸	色情
干你	色情
操死	色情
成人图	色情
narcotic	色情
美逼	色情
妹按摩	色情
porn	色情
性爱	色情
淫液	色情
色区	色情
淫叫	色情
下体	色情
张筱雨	色情
母奸	色情
双臀	色情
色情电影	色情
狗杂种	色情
套弄	色情
叫床	色情
体位	色情
成人色情	色情
婊子	色情
淫术炼金士	色情
多人轮	色情
迷情粉	色情
后庭	色情
自拍	色情
h动漫	色情
淫声浪语	色情
春药	色情
刹笔	色情
肉欲	色情
乳沟	色情
口爆	色情
淫妻	色情
虎骑	色情
刺激	色情
阴精	色情
揉乳	色情
我操	色情
情色	色情
操黑	色情
人妻	色情
男公关	色情
阴户	色情
开苞	色情
成人片	色情
迷奸粉	色情
sm	色情
招鸡	色情
插b	色情
傻逼	色情
亚情	色情
前凸后翘	色情
夜勤病栋	色情
色情服务	色情
操他妈	色情
放尿	色情
淫样	色情
巨乳	色情
狗操	色情
脱内裤	色情
一夜情	色情
品香堂	色情
汤加丽	色情
中年美妇	色情
金鳞岂是池中物	色情
学生妹	色情
小穴	色情
原味内衣	色情
吸精	色情
奈美	色情
风骚	色情
骚女	色情
乳交	色情
咪咪	色情
荡女	色情
蜜穴	色情
精液	色情
火辣	色情
干穴	色情
买春	色情
yin荡	色情
猛男	色情
美腿	色情
淫母	色情
不穿	色情
偷拍	色情
丝诱	色情
淫水	色情
按摩棒	色情
色盟	色情
阴唇	色情
厕奴	色情
乳爆	色情
龟头	色情
肉茎	色情
色猫	色情
玉女心经	色情
玉蒲团	色情
艳情小说	色情
爽片	色情
鸡奸	色情
射爽	色情
爽死我了	色情
阴间来电	色情
无耻	色情
裤袜	色情
99bb	色情
狼友	色情
迷昏藥	色情
成人dv	色情
金麟岂是池中物	色情
淫荡	色情
妈逼	色情
淫照	色情
性福情	色情
淫荡美女	色情
兽欲	色情
和弦	色情
色诱	色情
扌由插	色情
秘唇	色情
仓井空	色情
招妓	色情
浪逼	色情
阴核	色情
插比	色情
淫浪	色情
我草	色情
奸情	色情
一丝不挂	色情
干逼	色情
你妈的	色情
肉逼	色情
日烂	色情
淫虐	色情
淫电影	色情
性感妖娆	色情
全裸	色情
成人电	色情
傻比	色情
骚水	色情
轮暴	色情
手淫	色情
推油	色情
自慰	色情
色情网站	色情
美艳少妇	色情
集体淫	色情
死逼	色情
fuck	色情
色欲	色情
淫威	色情
干死你	色情
聊性	色情
卧艹	色情
爱女人	色情
脱光	色情
逼奸	色情
强暴	色情
淫荡视频	色情
白痴	色情
奶子	色情
我干	色情
伦理大	色情
迷昏口	色情
阴阜	色情
迷情水	色情
丝袜	色情
裸陪	色情
我就色	色情
换妻俱乐部	色情
色逼	色情
色界	色情
骚嘴	色情
巨奶	色情
乱交	色情
anal	色情
裸照	色情
骚逼	色情
沙比	色情
插阴	色情
淫騷妹	色情
性感诱惑	色情
妹上门	色情
兽奸	色情
豪乳	色情
操你全家	色情
暴乳	色情
骚浪	色情
骚比	色情
少妇	色情
限量	色情
a4u	色情
幼男	色情
舞女	色情
肉穴	色情
h动画	色情
骚货	色情
嫩穴	色情
脚交	色情
草泥马	色情
黑逼	色情
相奸	色情
迷奸药	色情
马勒	色情
adult	色情
全家不得好死	色情
情趣用品	色情
文做	色情
菊穴	色情
卧槽	色情
颜射	色情
娘西皮	色情
胸推	色情
发情	色情
乱伦	色情
爆你菊	色情
作爱	色情
淫糜	色情
裸舞视	色情
援助交际	色情
抽一插	色情
狂插	色情
抽插	色情
兼职	色情
暴干	色情
小逼	色情
砲友	色情
少年阿宾	色情
